"","Rank","NOC","Gold","Silver","Bronze","Total","Year"
"1",1,"United States",11,7,2,20,1896
"2",2,"Greece",10,18,19,47,1896
"3",3,"Germany",6,5,2,13,1896
"4",4,"France",5,4,2,11,1896
"5",5,"Great Britain",2,3,2,7,1896
"6",6,"Hungary",2,1,3,6,1896
"7",7,"Austria",2,1,2,5,1896
"8",8,"Australia",2,0,0,2,1896
"9",9,"Denmark",1,2,3,6,1896
"10",10,"Switzerland",1,2,0,3,1896
"11",11,"Mixed team",1,0,1,2,1896
"12",1,"France",27,39,37,103,1900
"13",2,"United States",19,14,15,48,1900
"14",3,"Great Britain",15,7,9,31,1900
"15",4,"Mixed team",8,5,6,19,1900
"16",5,"Belgium",6,7,4,17,1900
"17",6,"Switzerland",6,2,1,9,1900
"18",7,"Germany",4,3,2,9,1900
"19",8,"Italy",3,2,0,5,1900
"20",9,"Australia",2,0,3,5,1900
"21",10,"Denmark",1,3,2,6,1900
"22",11,"Hungary",1,2,2,5,1900
"23",12,"Cuba",1,1,0,2,1900
"24",13,"Canada",1,0,1,2,1900
"25",14,"Spain",1,0,0,1,1900
"26",14,"Luxembourg",1,0,0,1,1900
"27",16,"Austria",0,3,3,6,1900
"28",17,"Norway",0,2,3,5,1900
"29",17,"Netherlands",0,2,3,5,1900
"30",19,"India",0,2,0,2,1900
"31",20,"Bohemia",0,1,1,2,1900
"32",21,"Sweden",0,0,1,1,1900
"33",1,"United States",76,78,77,231,1904
"34",2,"Germany",4,5,6,15,1904
"35",3,"Canada",4,1,1,6,1904
"36",4,"Cuba",3,0,0,3,1904
"37",5,"Hungary",2,1,1,4,1904
"38",5,"Mixed team",2,1,1,4,1904
"39",7,"Norway",2,0,0,2,1904
"40",8,"Austria",1,1,1,3,1904
"41",9,"Great Britain",1,1,0,2,1904
"42",10,"Switzerland",1,0,2,3,1904
"43",11,"Greece",1,0,1,2,1904
"44",12,"Australia",0,3,1,4,1904
"45",13,"France",0,1,0,1,1904
"46",1,"Great Britain",56,51,39,146,1908
"47",2,"United States",23,12,12,47,1908
"48",3,"Sweden",8,6,11,25,1908
"49",4,"France",5,5,9,19,1908
"50",5,"Germany",3,5,5,13,1908
"51",6,"Hungary",3,4,2,9,1908
"52",7,"Canada",3,3,10,16,1908
"53",8,"Norway",2,3,3,8,1908
"54",9,"Italy",2,2,0,4,1908
"55",10,"Belgium",1,5,2,8,1908
"56",11,"Australasia",1,2,2,5,1908
"57",12,"Russian Empire",1,2,0,3,1908
"58",13,"Finland",1,1,3,5,1908
"59",14,"South Africa",1,1,0,2,1908
"60",15,"Greece",0,3,1,4,1908
"61",16,"Denmark",0,2,3,5,1908
"62",17,"Bohemia",0,0,2,2,1908
"63",17,"Netherlands",0,0,2,2,1908
"64",19,"Austria",0,0,1,1,1908
"65",1,"United States",26,19,19,64,1912
"66",2,"Sweden",23,25,17,65,1912
"67",3,"Great Britain",10,15,16,41,1912
"68",4,"Finland",9,8,9,26,1912
"69",5,"France",7,4,3,14,1912
"70",6,"Germany",5,13,7,25,1912
"71",7,"South Africa",4,2,0,6,1912
"72",8,"Norway",3,2,5,10,1912
"73",9,"Canada",3,2,3,8,1912
"74",9,"Hungary",3,2,3,8,1912
"75",11,"Italy",3,1,2,6,1912
"76",12,"Australasia",2,2,3,7,1912
"77",13,"Belgium",2,1,3,6,1912
"78",14,"Denmark",1,6,5,12,1912
"79",15,"Greece",1,0,1,2,1912
"80",16,"Russian Empire",0,2,3,5,1912
"81",17,"Austria",0,2,2,4,1912
"82",18,"Netherlands",0,0,3,3,1912
"83",1,"United States",41,27,27,95,1920
"84",2,"Sweden",19,20,25,64,1920
"85",3,"Finland",15,10,9,34,1920
"86",4,"Great Britain",14,15,13,42,1920
"87",5,"Belgium",14,11,11,36,1920
"88",6,"Norway",13,9,9,31,1920
"89",7,"Italy",13,5,5,23,1920
"90",8,"France",9,19,13,41,1920
"91",9,"Netherlands",4,2,5,11,1920
"92",10,"Denmark",3,9,1,13,1920
"93",11,"South Africa",3,4,3,10,1920
"94",12,"Canada",3,3,3,9,1920
"95",13,"Switzerland",2,2,7,11,1920
"96",14,"Estonia",1,2,0,3,1920
"97",15,"Brazil",1,1,1,3,1920
"98",16,"Australia",0,2,1,3,1920
"99",17,"Japan",0,2,0,2,1920
"100",17,"Spain",0,2,0,2,1920
"101",19,"Greece",0,1,0,1,1920
"102",19,"Luxembourg",0,1,0,1,1920
"103",21,"Czechoslovakia",0,0,2,2,1920
"104",22,"New Zealand",0,0,1,1,1920
"105",1,"United States",45,27,27,99,1924
"106",2,"Finland",14,13,10,37,1924
"107",3,"France",13,15,10,38,1924
"108",4,"Great Britain",9,13,12,34,1924
"109",5,"Italy",8,3,5,16,1924
"110",6,"Switzerland",7,8,10,25,1924
"111",7,"Norway",5,2,3,10,1924
"112",8,"Sweden",4,13,12,29,1924
"113",9,"Netherlands",4,1,5,10,1924
"114",10,"Belgium",3,7,3,13,1924
"115",11,"Australia",3,1,2,6,1924
"116",12,"Denmark",2,5,2,9,1924
"117",13,"Hungary",2,3,4,9,1924
"118",14,"Yugoslavia",2,0,0,2,1924
"119",15,"Czechoslovakia",1,4,5,10,1924
"120",16,"Argentina",1,3,2,6,1924
"121",17,"Estonia",1,1,4,6,1924
"122",18,"South Africa",1,1,1,3,1924
"123",19,"Uruguay",1,0,0,1,1924
"124",20,"Austria",0,3,1,4,1924
"125",20,"Canada",0,3,1,4,1924
"126",22,"Poland",0,1,1,2,1924
"127",23,"Haiti",0,0,1,1,1924
"128",23,"Japan",0,0,1,1,1924
"129",23,"New Zealand",0,0,1,1,1924
"130",23,"Portugal",0,0,1,1,1924
"131",23,"Romania",0,0,1,1,1924
"132",1,"United States",22,18,16,56,1928
"133",2,"Germany",10,7,14,31,1928
"134",3,"Finland",8,8,9,25,1928
"135",4,"Sweden",7,6,12,25,1928
"136",5,"Italy",7,5,7,19,1928
"137",6,"Switzerland",7,4,4,15,1928
"138",7,"France",6,10,5,21,1928
"139",8,"Netherlands",6,9,4,19,1928
"140",9,"Hungary",4,5,0,9,1928
"141",10,"Canada",4,4,7,15,1928
"142",11,"Great Britain",3,10,7,20,1928
"143",12,"Argentina",3,3,1,7,1928
"144",13,"Denmark",3,1,2,6,1928
"145",14,"Czechoslovakia",2,5,2,9,1928
"146",15,"Japan",2,2,1,5,1928
"147",16,"Estonia",2,1,2,5,1928
"148",17,"Egypt",2,1,1,4,1928
"149",18,"Austria",2,0,1,3,1928
"150",19,"Australia",1,2,1,4,1928
"151",19,"Norway",1,2,1,4,1928
"152",21,"Poland",1,1,3,5,1928
"153",21,"Yugoslavia",1,1,3,5,1928
"154",23,"South Africa",1,0,2,3,1928
"155",24,"India",1,0,0,1,1928
"156",24,"Ireland",1,0,0,1,1928
"157",24,"New Zealand",1,0,0,1,1928
"158",24,"Spain",1,0,0,1,1928
"159",24,"Uruguay",1,0,0,1,1928
"160",29,"Belgium",0,1,2,3,1928
"161",30,"Chile",0,1,0,1,1928
"162",30,"Haiti",0,1,0,1,1928
"163",32,"Philippines",0,0,1,1,1928
"164",32,"Portugal",0,0,1,1,1928
"165",1,"United States",44,36,30,110,1932
"166",2,"Italy",12,12,12,36,1932
"167",3,"France",11,5,4,20,1932
"168",4,"Sweden",10,5,9,24,1932
"169",5,"Japan",7,7,4,18,1932
"170",6,"Hungary",6,5,5,16,1932
"171",7,"Germany",5,12,7,24,1932
"172",8,"Finland",5,8,12,25,1932
"173",9,"Great Britain",5,7,5,17,1932
"174",10,"Poland",3,2,4,9,1932
"175",11,"Australia",3,1,1,5,1932
"176",12,"Argentina",3,1,0,4,1932
"177",13,"Canada",2,5,9,16,1932
"178",14,"Netherlands",2,5,1,8,1932
"179",15,"South Africa",2,0,3,5,1932
"180",16,"Ireland",2,0,0,2,1932
"181",17,"Czechoslovakia",1,3,2,6,1932
"182",18,"Austria",1,1,3,5,1932
"183",19,"India",1,0,0,1,1932
"184",20,"Denmark",0,5,3,8,1932
"185",21,"Mexico",0,2,0,2,1932
"186",22,"Latvia",0,1,0,1,1932
"187",22,"New Zealand",0,1,0,1,1932
"188",22,"Switzerland",0,1,0,1,1932
"189",25,"Philippines",0,0,3,3,1932
"190",26,"Belgium",0,0,1,1,1932
"191",26,"Spain",0,0,1,1,1932
"192",26,"Uruguay",0,0,1,1,1932
"193",1,"Germany",38,31,32,101,1936
"194",2,"United States",24,21,12,57,1936
"195",3,"Hungary",10,1,5,16,1936
"196",4,"Italy",9,13,5,27,1936
"197",5,"Finland",8,6,6,20,1936
"198",6,"France",7,6,6,19,1936
"199",7,"Sweden",6,5,10,21,1936
"200",8,"Japan",6,4,10,20,1936
"201",9,"Netherlands",6,4,7,17,1936
"202",10,"Austria",5,7,5,17,1936
"203",11,"Switzerland",4,9,5,18,1936
"204",12,"Great Britain",4,7,3,14,1936
"205",13,"Czechoslovakia",3,5,1,9,1936
"206",14,"Argentina",2,2,3,7,1936
"207",14,"Estonia",2,2,3,7,1936
"208",16,"Egypt",2,1,2,5,1936
"209",17,"Canada",1,3,5,9,1936
"210",18,"Norway",1,3,2,6,1936
"211",19,"Turkey",1,0,1,2,1936
"212",20,"India",1,0,0,1,1936
"213",20,"New Zealand",1,0,0,1,1936
"214",22,"Poland",0,4,5,9,1936
"215",23,"Denmark",0,2,3,5,1936
"216",24,"Latvia",0,1,1,2,1936
"217",25,"Romania",0,1,0,1,1936
"218",25,"South Africa",0,1,0,1,1936
"219",25,"Yugoslavia",0,1,0,1,1936
"220",28,"Belgium",0,0,3,3,1936
"221",28,"Mexico",0,0,3,3,1936
"222",30,"Australia",0,0,1,1,1936
"223",30,"Philippines",0,0,1,1,1936
"224",30,"Portugal",0,0,1,1,1936
"225",1,"United States",38,27,19,84,1948
"226",2,"Sweden",16,11,17,44,1948
"227",3,"France",10,6,13,29,1948
"228",4,"Hungary",10,5,12,27,1948
"229",5,"Italy",8,11,8,27,1948
"230",6,"Finland",8,7,5,20,1948
"231",7,"Turkey",6,4,2,12,1948
"232",8,"Czechoslovakia",6,2,3,11,1948
"233",9,"Switzerland",5,10,5,20,1948
"234",10,"Denmark",5,7,8,20,1948
"235",11,"Netherlands",5,2,9,16,1948
"236",12,"Great Britain",3,14,6,23,1948
"237",13,"Argentina",3,3,1,7,1948
"238",14,"Australia",2,6,5,13,1948
"239",15,"Belgium",2,2,3,7,1948
"240",16,"Egypt",2,2,1,5,1948
"241",17,"Mexico",2,1,2,5,1948
"242",18,"South Africa",2,1,1,4,1948
"243",19,"Norway",1,3,3,7,1948
"244",20,"Jamaica",1,2,0,3,1948
"245",21,"Austria",1,0,3,4,1948
"246",22,"India",1,0,0,1,1948
"247",22,"Peru",1,0,0,1,1948
"248",24,"Yugoslavia",0,2,0,2,1948
"249",25,"Canada",0,1,2,3,1948
"250",26,"Portugal",0,1,1,2,1948
"251",26,"Uruguay",0,1,1,2,1948
"252",28,"Ceylon",0,1,0,1,1948
"253",28,"Cuba",0,1,0,1,1948
"254",28,"Spain",0,1,0,1,1948
"255",28,"Trinidad and Tobago",0,1,0,1,1948
"256",32,"Panama",0,0,2,2,1948
"257",32,"South Korea",0,0,2,2,1948
"258",34,"Brazil",0,0,1,1,1948
"259",34,"Iran",0,0,1,1,1948
"260",34,"Poland",0,0,1,1,1948
"261",34,"Puerto Rico",0,0,1,1,1948
"262",1,"United States",40,19,17,76,1952
"263",2,"Soviet Union",22,30,19,71,1952
"264",3,"Hungary",16,10,16,42,1952
"265",4,"Sweden",12,13,10,35,1952
"266",5,"Italy",8,9,4,21,1952
"267",6,"Czechoslovakia",7,3,3,13,1952
"268",7,"France",6,6,6,18,1952
"269",8,"Finland",6,3,13,22,1952
"270",9,"Australia",6,2,3,11,1952
"271",10,"Norway",3,2,0,5,1952
"272",11,"Switzerland",2,6,6,14,1952
"273",12,"South Africa",2,4,4,10,1952
"274",13,"Jamaica",2,3,0,5,1952
"275",14,"Belgium",2,2,0,4,1952
"276",15,"Denmark",2,1,3,6,1952
"277",16,"Turkey",2,0,1,3,1952
"278",17,"Japan",1,6,2,9,1952
"279",18,"Great Britain",1,2,8,11,1952
"280",19,"Argentina",1,2,2,5,1952
"281",20,"Poland",1,2,1,4,1952
"282",21,"Canada",1,2,0,3,1952
"283",21,"Yugoslavia",1,2,0,3,1952
"284",23,"Romania",1,1,2,4,1952
"285",24,"Brazil",1,0,2,3,1952
"286",24,"New Zealand",1,0,2,3,1952
"287",26,"India",1,0,1,2,1952
"288",27,"Luxembourg",1,0,0,1,1952
"289",28,"Germany",0,7,17,24,1952
"290",29,"Netherlands",0,5,0,5,1952
"291",30,"Iran",0,3,4,7,1952
"292",31,"Chile",0,2,0,2,1952
"293",32,"Austria",0,1,1,2,1952
"294",32,"Lebanon",0,1,1,2,1952
"295",34,"Ireland",0,1,0,1,1952
"296",34,"Mexico",0,1,0,1,1952
"297",34,"Spain",0,1,0,1,1952
"298",37,"South Korea",0,0,2,2,1952
"299",37,"Trinidad and Tobago",0,0,2,2,1952
"300",37,"Uruguay",0,0,2,2,1952
"301",40,"Bulgaria",0,0,1,1,1952
"302",40,"Egypt",0,0,1,1,1952
"303",40,"Portugal",0,0,1,1,1952
"304",40,"Venezuela",0,0,1,1,1952
"305",1,"Soviet Union",37,29,32,98,1956
"306",2,"United States",32,25,17,74,1956
"307",3,"Australia",13,8,14,35,1956
"308",4,"Hungary",9,10,7,26,1956
"309",5,"Italy",8,8,9,25,1956
"310",6,"Sweden",8,5,6,19,1956
"311",7,"United Team of Germany",6,13,7,26,1956
"312",8,"Great Britain",6,7,11,24,1956
"313",9,"Romania",5,3,5,13,1956
"314",10,"Japan",4,10,5,19,1956
"315",11,"France",4,4,6,14,1956
"316",12,"Turkey",3,2,2,7,1956
"317",13,"Finland",3,1,11,15,1956
"318",14,"Iran",2,2,1,5,1956
"319",15,"Canada",2,1,3,6,1956
"320",16,"New Zealand",2,0,0,2,1956
"321",17,"Poland",1,4,4,9,1956
"322",18,"Czechoslovakia",1,4,1,6,1956
"323",19,"Bulgaria",1,3,1,5,1956
"324",20,"Denmark",1,2,1,4,1956
"325",21,"Ireland",1,1,3,5,1956
"326",22,"Norway",1,0,2,3,1956
"327",23,"Mexico",1,0,1,2,1956
"328",24,"Brazil",1,0,0,1,1956
"329",24,"India",1,0,0,1,1956
"330",26,"Yugoslavia",0,3,0,3,1956
"331",27,"Chile",0,2,2,4,1956
"332",28,"Belgium",0,2,0,2,1956
"333",29,"Argentina",0,1,1,2,1956
"334",29,"South Korea",0,1,1,2,1956
"335",31,"Iceland",0,1,0,1,1956
"336",31,"Pakistan",0,1,0,1,1956
"337",33,"South Africa",0,0,4,4,1956
"338",34,"Austria",0,0,2,2,1956
"339",35,"Bahamas",0,0,1,1,1956
"340",35,"Greece",0,0,1,1,1956
"341",35,"Switzerland",0,0,1,1,1956
"342",35,"Uruguay",0,0,1,1,1956
"343",1,"Soviet Union",43,29,31,103,1960
"344",2,"United States",34,21,16,71,1960
"345",3,"Italy",13,10,13,36,1960
"346",4,"United Team of Germany",12,19,11,42,1960
"347",5,"Australia",8,8,6,22,1960
"348",6,"Turkey",7,2,0,9,1960
"349",7,"Hungary",6,8,7,21,1960
"350",8,"Japan",4,7,7,18,1960
"351",9,"Poland",4,6,11,21,1960
"352",10,"Czechoslovakia",3,2,3,8,1960
"353",11,"Romania",3,1,6,10,1960
"354",12,"Great Britain",2,6,12,20,1960
"355",13,"Denmark",2,3,1,6,1960
"356",14,"New Zealand",2,0,1,3,1960
"357",15,"Bulgaria",1,3,3,7,1960
"358",16,"Sweden",1,2,3,6,1960
"359",17,"Finland",1,1,3,5,1960
"360",18,"Austria",1,1,0,2,1960
"361",18,"Yugoslavia",1,1,0,2,1960
"362",20,"Pakistan",1,0,1,2,1960
"363",21,"Ethiopia",1,0,0,1,1960
"364",21,"Greece",1,0,0,1,1960
"365",21,"Norway",1,0,0,1,1960
"366",24,"Switzerland",0,3,3,6,1960
"367",25,"France",0,2,3,5,1960
"368",26,"Belgium",0,2,2,4,1960
"369",27,"Iran",0,1,3,4,1960
"370",28,"Netherlands",0,1,2,3,1960
"371",28,"South Africa",0,1,2,3,1960
"372",30,"Argentina",0,1,1,2,1960
"373",30,"Egypt",0,1,1,2,1960
"374",32,"Canada",0,1,0,1,1960
"375",32,"Formosa",0,1,0,1,1960
"376",32,"Ghana",0,1,0,1,1960
"377",32,"India",0,1,0,1,1960
"378",32,"Morocco",0,1,0,1,1960
"379",32,"Portugal",0,1,0,1,1960
"380",32,"Singapore",0,1,0,1,1960
"381",39,"Brazil",0,0,2,2,1960
"382",39,"British West Indies",0,0,2,2,1960
"383",41,"Iraq",0,0,1,1,1960
"384",41,"Mexico",0,0,1,1,1960
"385",41,"Spain",0,0,1,1,1960
"386",41,"Venezuela",0,0,1,1,1960
"387",1,"United States",36,26,28,90,1964
"388",2,"Soviet Union",30,31,35,96,1964
"389",3,"Japan",16,5,8,29,1964
"390",4,"United Team of Germany",10,22,18,50,1964
"391",5,"Italy",10,10,7,27,1964
"392",6,"Hungary",10,7,5,22,1964
"393",7,"Poland",7,6,10,23,1964
"394",8,"Australia",6,2,10,18,1964
"395",9,"Czechoslovakia",5,6,3,14,1964
"396",10,"Great Britain",4,12,2,18,1964
"397",11,"Bulgaria",3,5,2,10,1964
"398",12,"Finland",3,0,2,5,1964
"399",12,"New Zealand",3,0,2,5,1964
"400",14,"Romania",2,4,6,12,1964
"401",15,"Netherlands",2,4,4,10,1964
"402",16,"Turkey",2,3,1,6,1964
"403",17,"Sweden",2,2,4,8,1964
"404",18,"Denmark",2,1,3,6,1964
"405",19,"Yugoslavia",2,1,2,5,1964
"406",20,"Belgium",2,0,1,3,1964
"407",21,"France",1,8,6,15,1964
"408",22,"Canada",1,2,1,4,1964
"409",22,"Switzerland",1,2,1,4,1964
"410",24,"Bahamas",1,0,0,1,1964
"411",24,"Ethiopia",1,0,0,1,1964
"412",24,"India",1,0,0,1,1964
"413",27,"South Korea",0,2,1,3,1964
"414",28,"Trinidad and Tobago",0,1,2,3,1964
"415",29,"Tunisia",0,1,1,2,1964
"416",30,"Argentina",0,1,0,1,1964
"417",30,"Cuba",0,1,0,1,1964
"418",30,"Pakistan",0,1,0,1,1964
"419",30,"Philippines",0,1,0,1,1964
"420",34,"Iran",0,0,2,2,1964
"421",35,"Brazil",0,0,1,1,1964
"422",35,"Ghana",0,0,1,1,1964
"423",35,"Ireland",0,0,1,1,1964
"424",35,"Kenya",0,0,1,1,1964
"425",35,"Mexico",0,0,1,1,1964
"426",35,"Nigeria",0,0,1,1,1964
"427",35,"Uruguay",0,0,1,1,1964
"428",1,"United States",45,28,34,107,1968
"429",2,"Soviet Union",29,32,30,91,1968
"430",3,"Japan",11,7,7,25,1968
"431",4,"Hungary",10,10,12,32,1968
"432",5,"East Germany",9,9,7,25,1968
"433",6,"France",7,3,5,15,1968
"434",7,"Czechoslovakia",7,2,4,13,1968
"435",8,"West Germany",5,11,10,26,1968
"436",9,"Australia",5,7,5,17,1968
"437",10,"Great Britain",5,5,3,13,1968
"438",11,"Poland",5,2,11,18,1968
"439",12,"Romania",4,6,5,15,1968
"440",13,"Italy",3,4,9,16,1968
"441",14,"Kenya",3,4,2,9,1968
"442",15,"Mexico",3,3,3,9,1968
"443",16,"Yugoslavia",3,3,2,8,1968
"444",17,"Netherlands",3,3,1,7,1968
"445",18,"Bulgaria",2,4,3,9,1968
"446",19,"Iran",2,1,2,5,1968
"447",20,"Sweden",2,1,1,4,1968
"448",21,"Turkey",2,0,0,2,1968
"449",22,"Denmark",1,4,3,8,1968
"450",23,"Canada",1,3,1,5,1968
"451",24,"Finland",1,2,1,4,1968
"452",25,"Ethiopia",1,1,0,2,1968
"453",25,"Norway",1,1,0,2,1968
"454",27,"New Zealand",1,0,2,3,1968
"455",28,"Tunisia",1,0,1,2,1968
"456",29,"Pakistan",1,0,0,1,1968
"457",29,"Venezuela",1,0,0,1,1968
"458",31,"Cuba",0,4,0,4,1968
"459",32,"Austria",0,2,2,4,1968
"460",33,"Switzerland",0,1,4,5,1968
"461",34,"Mongolia",0,1,3,4,1968
"462",35,"Brazil",0,1,2,3,1968
"463",36,"Belgium",0,1,1,2,1968
"464",36,"South Korea",0,1,1,2,1968
"465",36,"Uganda",0,1,1,2,1968
"466",39,"Cameroon",0,1,0,1,1968
"467",39,"Jamaica",0,1,0,1,1968
"468",41,"Argentina",0,0,2,2,1968
"469",42,"Greece",0,0,1,1,1968
"470",42,"India",0,0,1,1,1968
"471",42,"Taiwan",0,0,1,1,1968
"472",1,"Soviet Union",50,27,22,99,1972
"473",2,"United States",33,31,30,94,1972
"474",3,"East Germany",20,23,23,66,1972
"475",4,"West Germany",13,11,16,40,1972
"476",5,"Japan",13,8,8,29,1972
"477",6,"Australia",8,7,2,17,1972
"478",7,"Poland",7,5,9,21,1972
"479",8,"Hungary",6,13,16,35,1972
"480",9,"Bulgaria",6,10,5,21,1972
"481",10,"Italy",5,3,10,18,1972
"482",11,"Sweden",4,6,6,16,1972
"483",12,"Great Britain",4,5,9,18,1972
"484",13,"Romania",3,6,7,16,1972
"485",14,"Cuba",3,1,4,8,1972
"486",14,"Finland",3,1,4,8,1972
"487",16,"Netherlands",3,1,1,5,1972
"488",17,"France",2,4,7,13,1972
"489",18,"Czechoslovakia",2,4,2,8,1972
"490",19,"Kenya",2,3,4,9,1972
"491",20,"Yugoslavia",2,1,2,5,1972
"492",21,"Norway",2,1,1,4,1972
"493",22,"North Korea",1,1,3,5,1972
"494",23,"New Zealand",1,1,1,3,1972
"495",24,"Uganda",1,1,0,2,1972
"496",25,"Denmark",1,0,0,1,1972
"497",26,"Switzerland",0,3,0,3,1972
"498",27,"Canada",0,2,3,5,1972
"499",28,"Iran",0,2,1,3,1972
"500",29,"Belgium",0,2,0,2,1972
"501",29,"Greece",0,2,0,2,1972
"502",31,"Austria",0,1,2,3,1972
"503",31,"Colombia",0,1,2,3,1972
"504",33,"Argentina",0,1,0,1,1972
"505",33,"Lebanon",0,1,0,1,1972
"506",33,"Mexico",0,1,0,1,1972
"507",33,"Mongolia",0,1,0,1,1972
"508",33,"Pakistan",0,1,0,1,1972
"509",33,"South Korea",0,1,0,1,1972
"510",33,"Tunisia",0,1,0,1,1972
"511",33,"Turkey",0,1,0,1,1972
"512",41,"Brazil",0,0,2,2,1972
"513",41,"Ethiopia",0,0,2,2,1972
"514",43,"Ghana",0,0,1,1,1972
"515",43,"India",0,0,1,1,1972
"516",43,"Jamaica",0,0,1,1,1972
"517",43,"Niger",0,0,1,1,1972
"518",43,"Nigeria",0,0,1,1,1972
"519",43,"Spain",0,0,1,1,1972
"520",1,"Soviet Union",49,41,35,125,1976
"521",2,"East Germany",40,25,25,90,1976
"522",3,"United States",34,35,25,94,1976
"523",4,"West Germany",10,12,17,39,1976
"524",5,"Japan",9,6,10,25,1976
"525",6,"Poland",7,6,13,26,1976
"526",7,"Bulgaria",6,9,7,22,1976
"527",8,"Cuba",6,4,3,13,1976
"528",9,"Romania",4,9,14,27,1976
"529",10,"Hungary",4,5,13,22,1976
"530",11,"Finland",4,2,0,6,1976
"531",12,"Sweden",4,1,0,5,1976
"532",13,"Great Britain",3,5,5,13,1976
"533",14,"Italy",2,7,4,13,1976
"534",15,"France",2,3,4,9,1976
"535",16,"Yugoslavia",2,3,3,8,1976
"536",17,"Czechoslovakia",2,2,4,8,1976
"537",18,"New Zealand",2,1,1,4,1976
"538",19,"South Korea",1,1,4,6,1976
"539",20,"Switzerland",1,1,2,4,1976
"540",21,"Jamaica",1,1,0,2,1976
"541",21,"North Korea",1,1,0,2,1976
"542",21,"Norway",1,1,0,2,1976
"543",24,"Denmark",1,0,2,3,1976
"544",25,"Mexico",1,0,1,2,1976
"545",26,"Trinidad and Tobago",1,0,0,1,1976
"546",27,"Canada",0,5,6,11,1976
"547",28,"Belgium",0,3,3,6,1976
"548",29,"Netherlands",0,2,3,5,1976
"549",30,"Portugal",0,2,0,2,1976
"550",30,"Spain",0,2,0,2,1976
"551",32,"Australia",0,1,4,5,1976
"552",33,"Iran",0,1,1,2,1976
"553",34,"Mongolia",0,1,0,1,1976
"554",34,"Venezuela",0,1,0,1,1976
"555",36,"Brazil",0,0,2,2,1976
"556",37,"Austria",0,0,1,1,1976
"557",37,"Bermuda",0,0,1,1,1976
"558",37,"Pakistan",0,0,1,1,1976
"559",37,"Puerto Rico",0,0,1,1,1976
"560",37,"Thailand",0,0,1,1,1976
"561",1,"Soviet Union",80,69,46,195,1980
"562",2,"East Germany",47,37,42,126,1980
"563",3,"Bulgaria",8,16,17,41,1980
"564",4,"Cuba",8,7,5,20,1980
"565",5,"Italy",8,3,4,15,1980
"566",6,"Hungary",7,10,15,32,1980
"567",7,"Romania",6,6,13,25,1980
"568",8,"France",6,5,3,14,1980
"569",9,"Great Britain",5,7,9,21,1980
"570",10,"Poland",3,14,15,32,1980
"571",11,"Sweden",3,3,6,12,1980
"572",12,"Finland",3,1,4,8,1980
"573",13,"Czechoslovakia",2,3,9,14,1980
"574",14,"Yugoslavia",2,3,4,9,1980
"575",15,"Australia",2,2,5,9,1980
"576",16,"Denmark",2,1,2,5,1980
"577",17,"Brazil",2,0,2,4,1980
"578",17,"Ethiopia",2,0,2,4,1980
"579",19,"Switzerland",2,0,0,2,1980
"580",20,"Spain",1,3,2,6,1980
"581",21,"Austria",1,2,1,4,1980
"582",22,"Greece",1,0,2,3,1980
"583",23,"Belgium",1,0,0,1,1980
"584",23,"India",1,0,0,1,1980
"585",23,"Zimbabwe",1,0,0,1,1980
"586",26,"North Korea",0,3,2,5,1980
"587",27,"Mongolia",0,2,2,4,1980
"588",28,"Tanzania",0,2,0,2,1980
"589",29,"Mexico",0,1,3,4,1980
"590",30,"Netherlands",0,1,2,3,1980
"591",31,"Ireland",0,1,1,2,1980
"592",32,"Uganda",0,1,0,1,1980
"593",32,"Venezuela",0,1,0,1,1980
"594",34,"Jamaica",0,0,3,3,1980
"595",35,"Guyana",0,0,1,1,1980
"596",35,"Lebanon",0,0,1,1,1980
"597",1,"United States",83,61,30,174,1984
"598",2,"Romania",20,16,17,53,1984
"599",3,"West Germany",17,19,23,59,1984
"600",4,"China",15,8,9,32,1984
"601",5,"Italy",14,6,12,32,1984
"602",6,"Canada",10,18,16,44,1984
"603",7,"Japan",10,8,14,32,1984
"604",8,"New Zealand",8,1,2,11,1984
"605",9,"Yugoslavia",7,4,7,18,1984
"606",10,"South Korea",6,6,7,19,1984
"607",11,"Great Britain",5,11,21,37,1984
"608",12,"France",5,7,16,28,1984
"609",13,"Netherlands",5,2,6,13,1984
"610",14,"Australia",4,8,12,24,1984
"611",15,"Finland",4,2,6,12,1984
"612",16,"Sweden",2,11,6,19,1984
"613",17,"Mexico",2,3,1,6,1984
"614",18,"Morocco",2,0,0,2,1984
"615",19,"Brazil",1,5,2,8,1984
"616",20,"Spain",1,2,2,5,1984
"617",21,"Belgium",1,1,2,4,1984
"618",22,"Austria",1,1,1,3,1984
"619",23,"Kenya",1,0,2,3,1984
"620",23,"Portugal",1,0,2,3,1984
"621",25,"Pakistan",1,0,0,1,1984
"622",26,"Switzerland",0,4,4,8,1984
"623",27,"Denmark",0,3,3,6,1984
"624",28,"Jamaica",0,1,2,3,1984
"625",28,"Norway",0,1,2,3,1984
"626",30,"Greece",0,1,1,2,1984
"627",30,"Nigeria",0,1,1,2,1984
"628",30,"Puerto Rico",0,1,1,2,1984
"629",33,"Colombia",0,1,0,1,1984
"630",33,"Egypt",0,1,0,1,1984
"631",33,"Ireland",0,1,0,1,1984
"632",33,"Ivory Coast",0,1,0,1,1984
"633",33,"Peru",0,1,0,1,1984
"634",33,"Syria",0,1,0,1,1984
"635",33,"Thailand",0,1,0,1,1984
"636",40,"Turkey",0,0,3,3,1984
"637",40,"Venezuela",0,0,3,3,1984
"638",42,"Algeria",0,0,2,2,1984
"639",43,"Cameroon",0,0,1,1,1984
"640",43,"Chinese Taipei",0,0,1,1,1984
"641",43,"Dominican Republic",0,0,1,1,1984
"642",43,"Iceland",0,0,1,1,1984
"643",43,"Zambia",0,0,1,1,1984
"644",1,"Soviet Union",55,31,46,132,1988
"645",2,"East Germany",37,35,30,102,1988
"646",3,"United States",36,31,27,94,1988
"647",4,"South Korea",12,10,11,33,1988
"648",5,"West Germany",11,14,15,40,1988
"649",6,"Hungary",11,6,6,23,1988
"650",7,"Bulgaria",10,12,13,35,1988
"651",8,"Romania",7,11,6,24,1988
"652",9,"France",6,4,6,16,1988
"653",10,"Italy",6,4,4,14,1988
"654",11,"China",5,11,12,28,1988
"655",12,"Great Britain",5,10,9,24,1988
"656",13,"Kenya",5,2,2,9,1988
"657",14,"Japan",4,3,7,14,1988
"658",15,"Australia",3,6,5,14,1988
"659",16,"Yugoslavia",3,4,5,12,1988
"660",17,"Czechoslovakia",3,3,2,8,1988
"661",18,"New Zealand",3,2,8,13,1988
"662",19,"Canada",3,2,5,10,1988
"663",20,"Poland",2,5,9,16,1988
"664",21,"Norway",2,3,0,5,1988
"665",22,"Netherlands",2,2,5,9,1988
"666",23,"Denmark",2,1,1,4,1988
"667",24,"Brazil",1,2,3,6,1988
"668",25,"Finland",1,1,2,4,1988
"669",25,"Spain",1,1,2,4,1988
"670",27,"Turkey",1,1,0,2,1988
"671",28,"Morocco",1,0,2,3,1988
"672",29,"Austria",1,0,0,1,1988
"673",29,"Portugal",1,0,0,1,1988
"674",29,"Suriname",1,0,0,1,1988
"675",32,"Sweden",0,4,7,11,1988
"676",33,"Switzerland",0,2,2,4,1988
"677",34,"Jamaica",0,2,0,2,1988
"678",35,"Argentina",0,1,1,2,1988
"679",36,"Chile",0,1,0,1,1988
"680",36,"Costa Rica",0,1,0,1,1988
"681",36,"Indonesia",0,1,0,1,1988
"682",36,"Iran",0,1,0,1,1988
"683",36,"Netherlands Antilles",0,1,0,1,1988
"684",36,"Peru",0,1,0,1,1988
"685",36,"Senegal",0,1,0,1,1988
"686",36,"Virgin Islands",0,1,0,1,1988
"687",44,"Belgium",0,0,2,2,1988
"688",44,"Mexico",0,0,2,2,1988
"689",46,"Colombia",0,0,1,1,1988
"690",46,"Djibouti",0,0,1,1,1988
"691",46,"Greece",0,0,1,1,1988
"692",46,"Mongolia",0,0,1,1,1988
"693",46,"Pakistan",0,0,1,1,1988
"694",46,"Philippines",0,0,1,1,1988
"695",46,"Thailand",0,0,1,1,1988
"696",1,"Unified Team",45,38,29,112,1992
"697",2,"United States",37,34,37,108,1992
"698",3,"Germany",33,21,28,82,1992
"699",4,"China",16,22,16,54,1992
"700",5,"Cuba",14,6,11,31,1992
"701",6,"Spain",13,7,2,22,1992
"702",7,"South Korea",12,5,12,29,1992
"703",8,"Hungary",11,12,7,30,1992
"704",9,"France",8,5,16,29,1992
"705",10,"Australia",7,9,11,27,1992
"706",11,"Canada",7,4,7,18,1992
"707",12,"Italy",6,5,8,19,1992
"708",13,"Great Britain",5,3,12,20,1992
"709",14,"Romania",4,6,8,18,1992
"710",15,"Czechoslovakia",4,2,1,7,1992
"711",16,"North Korea",4,0,5,9,1992
"712",17,"Japan",3,8,11,22,1992
"713",18,"Bulgaria",3,7,6,16,1992
"714",19,"Poland",3,6,10,19,1992
"715",20,"Netherlands",2,6,7,15,1992
"716",21,"Kenya",2,4,2,8,1992
"717",22,"Norway",2,4,1,7,1992
"718",23,"Turkey",2,2,2,6,1992
"719",24,"Indonesia",2,2,1,5,1992
"720",25,"Brazil",2,1,0,3,1992
"721",26,"Greece",2,0,0,2,1992
"722",27,"Sweden",1,7,4,12,1992
"723",28,"New Zealand",1,4,5,10,1992
"724",29,"Finland",1,2,2,5,1992
"725",30,"Denmark",1,1,4,6,1992
"726",31,"Morocco",1,1,1,3,1992
"727",32,"Ireland",1,1,0,2,1992
"728",33,"Ethiopia",1,0,2,3,1992
"729",34,"Algeria",1,0,1,2,1992
"730",34,"Estonia",1,0,1,2,1992
"731",34,"Lithuania",1,0,1,2,1992
"732",37,"Switzerland",1,0,0,1,1992
"733",38,"Jamaica",0,3,1,4,1992
"734",38,"Nigeria",0,3,1,4,1992
"735",40,"Latvia",0,2,1,3,1992
"736",41,"Austria",0,2,0,2,1992
"737",41,"Namibia",0,2,0,2,1992
"738",41,"South Africa",0,2,0,2,1992
"739",44,"Belgium",0,1,2,3,1992
"740",44,"Croatia",0,1,2,3,1992
"741",44,"Independent Olympic Participants",0,1,2,3,1992
"742",44,"Iran",0,1,2,3,1992
"743",48,"Israel",0,1,1,2,1992
"744",49,"Chinese Taipei",0,1,0,1,1992
"745",49,"Mexico",0,1,0,1,1992
"746",49,"Peru",0,1,0,1,1992
"747",52,"Mongolia",0,0,2,2,1992
"748",52,"Slovenia",0,0,2,2,1992
"749",54,"Argentina",0,0,1,1,1992
"750",54,"Bahamas",0,0,1,1,1992
"751",54,"Colombia",0,0,1,1,1992
"752",54,"Ghana",0,0,1,1,1992
"753",54,"Malaysia",0,0,1,1,1992
"754",54,"Pakistan",0,0,1,1,1992
"755",54,"Philippines",0,0,1,1,1992
"756",54,"Puerto Rico",0,0,1,1,1992
"757",54,"Qatar",0,0,1,1,1992
"758",54,"Suriname",0,0,1,1,1992
"759",54,"Thailand",0,0,1,1,1992
"760",1,"United States",44,32,25,101,1996
"761",2,"Russia",26,21,16,63,1996
"762",3,"Germany",20,18,27,65,1996
"763",4,"China",16,22,12,50,1996
"764",5,"France",15,7,15,37,1996
"765",6,"Italy",13,10,12,35,1996
"766",7,"Australia",9,9,23,41,1996
"767",8,"Cuba",9,8,8,25,1996
"768",9,"Ukraine",9,2,12,23,1996
"769",10,"South Korea",7,15,5,27,1996
"770",11,"Poland",7,5,5,17,1996
"771",12,"Hungary",7,4,10,21,1996
"772",13,"Spain",5,6,6,17,1996
"773",14,"Romania",4,7,9,20,1996
"774",15,"Netherlands",4,5,10,19,1996
"775",16,"Greece",4,4,0,8,1996
"776",17,"Czech Republic",4,3,4,11,1996
"777",18,"Switzerland",4,3,0,7,1996
"778",19,"Denmark",4,1,1,6,1996
"779",19,"Turkey",4,1,1,6,1996
"780",21,"Canada",3,11,8,22,1996
"781",22,"Bulgaria",3,7,5,15,1996
"782",23,"Japan",3,6,5,14,1996
"783",24,"Kazakhstan",3,4,4,11,1996
"784",25,"Brazil",3,3,9,15,1996
"785",26,"New Zealand",3,2,1,6,1996
"786",27,"South Africa",3,1,1,5,1996
"787",28,"Ireland",3,0,1,4,1996
"788",29,"Sweden",2,4,2,8,1996
"789",30,"Norway",2,2,3,7,1996
"790",31,"Belgium",2,2,2,6,1996
"791",32,"Nigeria",2,1,3,6,1996
"792",33,"North Korea",2,1,2,5,1996
"793",34,"Algeria",2,0,1,3,1996
"794",34,"Ethiopia",2,0,1,3,1996
"795",36,"Great Britain",1,8,6,15,1996
"796",37,"Belarus",1,6,8,15,1996
"797",38,"Kenya",1,4,3,8,1996
"798",39,"Jamaica",1,3,2,6,1996
"799",40,"Finland",1,2,1,4,1996
"800",41,"FR Yugoslavia",1,1,2,4,1996
"801",41,"Indonesia",1,1,2,4,1996
"802",43,"Iran",1,1,1,3,1996
"803",43,"Slovakia",1,1,1,3,1996
"804",45,"Armenia",1,1,0,2,1996
"805",45,"Croatia",1,1,0,2,1996
"806",47,"Portugal",1,0,1,2,1996
"807",47,"Thailand",1,0,1,2,1996
"808",49,"Burundi",1,0,0,1,1996
"809",49,"Costa Rica",1,0,0,1,1996
"810",49,"Ecuador",1,0,0,1,1996
"811",49,"Hong Kong",1,0,0,1,1996
"812",49,"Syria",1,0,0,1,1996
"813",54,"Argentina",0,2,1,3,1996
"814",55,"Namibia",0,2,0,2,1996
"815",55,"Slovenia",0,2,0,2,1996
"816",57,"Austria",0,1,2,3,1996
"817",58,"Malaysia",0,1,1,2,1996
"818",58,"Moldova",0,1,1,2,1996
"819",58,"Uzbekistan",0,1,1,2,1996
"820",61,"Azerbaijan",0,1,0,1,1996
"821",61,"Bahamas",0,1,0,1,1996
"822",61,"Chinese Taipei",0,1,0,1,1996
"823",61,"Latvia",0,1,0,1,1996
"824",61,"Philippines",0,1,0,1,1996
"825",61,"Tonga",0,1,0,1,1996
"826",61,"Zambia",0,1,0,1,1996
"827",68,"Georgia",0,0,2,2,1996
"828",68,"Morocco",0,0,2,2,1996
"829",68,"Trinidad and Tobago",0,0,2,2,1996
"830",71,"India",0,0,1,1,1996
"831",71,"Israel",0,0,1,1,1996
"832",71,"Lithuania",0,0,1,1,1996
"833",71,"Mexico",0,0,1,1,1996
"834",71,"Mongolia",0,0,1,1,1996
"835",71,"Mozambique",0,0,1,1,1996
"836",71,"Puerto Rico",0,0,1,1,1996
"837",71,"Tunisia",0,0,1,1,1996
"838",71,"Uganda",0,0,1,1,1996
"839",1,"United States",37,24,32,93,2000
"840",2,"Russia",32,28,29,89,2000
"841",3,"China",28,16,14,58,2000
"842",4,"Australia",16,25,17,58,2000
"843",5,"Germany",13,17,26,56,2000
"844",6,"France",13,14,11,38,2000
"845",7,"Italy",13,8,13,34,2000
"846",8,"Netherlands",12,9,4,25,2000
"847",9,"Cuba",11,11,7,29,2000
"848",10,"Great Britain",11,10,7,28,2000
"849",11,"Romania",11,6,9,26,2000
"850",12,"South Korea",8,10,10,28,2000
"851",13,"Hungary",8,6,3,17,2000
"852",14,"Poland",6,5,3,14,2000
"853",15,"Japan",5,8,5,18,2000
"854",16,"Bulgaria",5,6,2,13,2000
"855",17,"Greece",4,6,3,13,2000
"856",18,"Sweden",4,5,3,12,2000
"857",19,"Norway",4,3,3,10,2000
"858",20,"Ethiopia",4,1,3,8,2000
"859",21,"Ukraine",3,10,10,23,2000
"860",22,"Kazakhstan",3,4,0,7,2000
"861",23,"Belarus",3,3,11,17,2000
"862",24,"Canada",3,3,8,14,2000
"863",25,"Spain",3,3,5,11,2000
"864",26,"Turkey",3,0,2,5,2000
"865",27,"Iran",3,0,1,4,2000
"866",28,"Czech Republic",2,3,3,8,2000
"867",29,"Kenya",2,3,2,7,2000
"868",30,"Denmark",2,3,1,6,2000
"869",31,"Finland",2,1,1,4,2000
"870",32,"Austria",2,1,0,3,2000
"871",33,"Lithuania",2,0,3,5,2000
"872",34,"Azerbaijan",2,0,1,3,2000
"873",34,"Bahamas",2,0,1,3,2000
"874",36,"Slovenia",2,0,0,2,2000
"875",37,"Switzerland",1,6,2,9,2000
"876",38,"Indonesia",1,3,2,6,2000
"877",39,"Slovakia",1,3,1,5,2000
"878",40,"Mexico",1,2,3,6,2000
"879",41,"Nigeria",1,2,0,3,2000
"880",42,"Algeria",1,1,3,5,2000
"881",43,"Uzbekistan",1,1,2,4,2000
"882",44,"FR Yugoslavia",1,1,1,3,2000
"883",44,"Latvia",1,1,1,3,2000
"884",46,"New Zealand",1,0,3,4,2000
"885",47,"Estonia",1,0,2,3,2000
"886",47,"Thailand",1,0,2,3,2000
"887",49,"Croatia",1,0,1,2,2000
"888",50,"Cameroon",1,0,0,1,2000
"889",50,"Colombia",1,0,0,1,2000
"890",50,"Mozambique",1,0,0,1,2000
"891",53,"Brazil",0,6,6,12,2000
"892",54,"Jamaica",0,6,3,9,2000
"893",55,"Belgium",0,2,3,5,2000
"894",55,"South Africa",0,2,3,5,2000
"895",57,"Argentina",0,2,2,4,2000
"896",58,"Chinese Taipei",0,1,4,5,2000
"897",58,"Morocco",0,1,4,5,2000
"898",60,"North Korea",0,1,3,4,2000
"899",61,"Moldova",0,1,1,2,2000
"900",61,"Saudi Arabia",0,1,1,2,2000
"901",61,"Trinidad and Tobago",0,1,1,2,2000
"902",64,"Ireland",0,1,0,1,2000
"903",64,"Sri Lanka",0,1,0,1,2000
"904",64,"Uruguay",0,1,0,1,2000
"905",64,"Vietnam",0,1,0,1,2000
"906",68,"Georgia",0,0,6,6,2000
"907",69,"Costa Rica",0,0,2,2,2000
"908",69,"Portugal",0,0,2,2,2000
"909",71,"Armenia",0,0,1,1,2000
"910",71,"Barbados",0,0,1,1,2000
"911",71,"Chile",0,0,1,1,2000
"912",71,"Iceland",0,0,1,1,2000
"913",71,"India",0,0,1,1,2000
"914",71,"Israel",0,0,1,1,2000
"915",71,"Kuwait",0,0,1,1,2000
"916",71,"Kyrgyzstan",0,0,1,1,2000
"917",71,"Macedonia",0,0,1,1,2000
"918",71,"Qatar",0,0,1,1,2000
"919",1,"United States",36,39,26,101,2004
"920",2,"China",32,17,14,63,2004
"921",3,"Russia",28,26,36,90,2004
"922",4,"Australia",17,16,17,50,2004
"923",5,"Japan",16,9,12,37,2004
"924",6,"Germany",13,16,20,49,2004
"925",7,"France",11,9,13,33,2004
"926",8,"Italy",10,11,11,32,2004
"927",9,"South Korea",9,12,9,30,2004
"928",10,"Great Britain",9,9,12,30,2004
"929",11,"Cuba",9,7,11,27,2004
"930",12,"Hungary",8,6,3,17,2004
"931",13,"Ukraine",8,5,9,22,2004
"932",14,"Romania",8,5,6,19,2004
"933",15,"Greece",6,6,4,16,2004
"934",16,"Brazil",5,2,3,10,2004
"935",17,"Norway",5,0,1,6,2004
"936",18,"Netherlands",4,9,9,22,2004
"937",19,"Sweden",4,2,1,7,2004
"938",20,"Spain",3,11,6,20,2004
"939",21,"Canada",3,6,3,12,2004
"940",22,"Turkey",3,3,4,10,2004
"941",23,"Poland",3,2,5,10,2004
"942",24,"New Zealand",3,2,0,5,2004
"943",25,"Thailand",3,1,4,8,2004
"944",26,"Belarus",2,5,6,13,2004
"945",27,"Austria",2,4,1,7,2004
"946",28,"Ethiopia",2,3,2,7,2004
"947",29,"Iran",2,2,2,6,2004
"948",29,"Slovakia",2,2,2,6,2004
"949",31,"Chinese Taipei",2,2,1,5,2004
"950",32,"Georgia",2,2,0,4,2004
"951",33,"Bulgaria",2,1,9,12,2004
"952",34,"Denmark",2,1,5,8,2004
"953",35,"Jamaica",2,1,2,5,2004
"954",35,"Uzbekistan",2,1,2,5,2004
"955",37,"Morocco",2,1,0,3,2004
"956",38,"Argentina",2,0,4,6,2004
"957",39,"Chile",2,0,1,3,2004
"958",40,"Kazakhstan",1,4,3,8,2004
"959",41,"Kenya",1,4,2,7,2004
"960",42,"Czech Republic",1,3,5,9,2004
"961",43,"South Africa",1,3,2,6,2004
"962",44,"Croatia",1,2,2,5,2004
"963",45,"Lithuania",1,2,0,3,2004
"964",46,"Egypt",1,1,3,5,2004
"965",46,"Switzerland",1,1,3,5,2004
"966",48,"Indonesia",1,1,2,4,2004
"967",49,"Zimbabwe",1,1,1,3,2004
"968",50,"Azerbaijan",1,0,4,5,2004
"969",51,"Belgium",1,0,2,3,2004
"970",52,"Bahamas",1,0,1,2,2004
"971",52,"Israel",1,0,1,2,2004
"972",54,"Cameroon",1,0,0,1,2004
"973",54,"Dominican Republic",1,0,0,1,2004
"974",54,"United Arab Emirates",1,0,0,1,2004
"975",57,"North Korea",0,4,1,5,2004
"976",58,"Latvia",0,4,0,4,2004
"977",59,"Mexico",0,3,1,4,2004
"978",60,"Portugal",0,2,1,3,2004
"979",61,"Finland",0,2,0,2,2004
"980",61,"Serbia and Montenegro",0,2,0,2,2004
"981",63,"Slovenia",0,1,3,4,2004
"982",64,"Estonia",0,1,2,3,2004
"983",65,"Hong Kong",0,1,0,1,2004
"984",65,"India",0,1,0,1,2004
"985",65,"Paraguay",0,1,0,1,2004
"986",68,"Colombia",0,0,2,2,2004
"987",68,"Nigeria",0,0,2,2,2004
"988",68,"Venezuela",0,0,2,2,2004
"989",71,"Eritrea",0,0,1,1,2004
"990",71,"Mongolia",0,0,1,1,2004
"991",71,"Syria",0,0,1,1,2004
"992",71,"Trinidad and Tobago",0,0,1,1,2004
"993",1,"China",48,22,30,100,2008
"994",2,"United States",36,39,37,112,2008
"995",3,"Russia",24,13,23,60,2008
"996",4,"Great Britain",19,13,19,51,2008
"997",5,"Germany",16,11,14,41,2008
"998",6,"Australia",14,15,17,46,2008
"999",7,"South Korea",13,11,8,32,2008
"1000",8,"Japan",9,8,8,25,2008
"1001",9,"Italy",8,9,10,27,2008
"1002",10,"France",7,16,20,43,2008
"1003",11,"Netherlands",7,5,4,16,2008
"1004",12,"Ukraine",7,4,11,22,2008
"1005",13,"Kenya",6,4,6,16,2008
"1006",14,"Spain",5,11,3,19,2008
"1007",15,"Jamaica",5,4,2,11,2008
"1008",16,"Poland",4,5,2,11,2008
"1009",17,"Ethiopia",4,2,1,7,2008
"1010",18,"Romania",4,1,4,9,2008
"1011",19,"Cuba",3,10,17,30,2008
"1012",20,"Canada",3,9,8,20,2008
"1013",21,"Hungary",3,5,2,10,2008
"1014",22,"Norway",3,5,1,9,2008
"1015",23,"Brazil",3,4,10,17,2008
"1016",24,"Belarus",3,4,7,14,2008
"1017",25,"Czech Republic",3,3,1,7,2008
"1018",26,"Slovakia",3,3,0,6,2008
"1019",27,"New Zealand",3,2,4,9,2008
"1020",28,"Georgia",3,2,2,7,2008
"1021",29,"Kazakhstan",2,3,4,9,2008
"1022",30,"Denmark",2,2,3,7,2008
"1023",31,"North Korea",2,2,2,6,2008
"1024",31,"Thailand",2,2,2,6,2008
"1025",33,"Mongolia",2,2,0,4,2008
"1026",34,"Switzerland",2,1,4,7,2008
"1027",35,"Argentina",2,0,4,6,2008
"1028",36,"Mexico",2,0,2,4,2008
"1029",37,"Belgium",2,0,0,2,2008
"1030",38,"Zimbabwe",1,3,0,4,2008
"1031",39,"Slovenia",1,2,2,5,2008
"1032",40,"Azerbaijan",1,1,4,6,2008
"1033",40,"Indonesia",1,1,4,6,2008
"1034",42,"Bulgaria",1,1,3,5,2008
"1035",42,"Turkey",1,1,3,5,2008
"1036",44,"Chinese Taipei",1,1,2,4,2008
"1037",44,"Finland",1,1,2,4,2008
"1038",46,"Latvia",1,1,1,3,2008
"1039",47,"Dominican Republic",1,1,0,2,2008
"1040",47,"Estonia",1,1,0,2,2008
"1041",47,"Portugal",1,1,0,2,2008
"1042",47,"Trinidad and Tobago",1,1,0,2,2008
"1043",51,"India",1,0,2,3,2008
"1044",52,"Iran",1,0,1,2,2008
"1045",53,"Cameroon",1,0,0,1,2008
"1046",53,"Panama",1,0,0,1,2008
"1047",53,"Tunisia",1,0,0,1,2008
"1048",56,"Sweden",0,4,1,5,2008
"1049",57,"Lithuania",0,3,2,5,2008
"1050",57,"Nigeria",0,3,2,5,2008
"1051",59,"Croatia",0,2,3,5,2008
"1052",60,"Colombia",0,2,1,3,2008
"1053",60,"Greece",0,2,1,3,2008
"1054",62,"Armenia",0,1,4,5,2008
"1055",63,"Uzbekistan",0,1,3,4,2008
"1056",64,"Austria",0,1,2,3,2008
"1057",64,"Ireland",0,1,2,3,2008
"1058",64,"Kyrgyzstan",0,1,2,3,2008
"1059",64,"Serbia",0,1,2,3,2008
"1060",68,"Algeria",0,1,1,2,2008
"1061",68,"Bahamas",0,1,1,2,2008
"1062",68,"Morocco",0,1,1,2,2008
"1063",68,"Tajikistan",0,1,1,2,2008
"1064",72,"Chile",0,1,0,1,2008
"1065",72,"Ecuador",0,1,0,1,2008
"1066",72,"Iceland",0,1,0,1,2008
"1067",72,"Malaysia",0,1,0,1,2008
"1068",72,"Samoa",0,1,0,1,2008
"1069",72,"Singapore",0,1,0,1,2008
"1070",72,"South Africa",0,1,0,1,2008
"1071",72,"Sudan",0,1,0,1,2008
"1072",72,"Vietnam",0,1,0,1,2008
"1073",81,"Egypt",0,0,2,2,2008
"1074",82,"Afghanistan",0,0,1,1,2008
"1075",82,"Israel",0,0,1,1,2008
"1076",82,"Mauritius",0,0,1,1,2008
"1077",82,"Moldova",0,0,1,1,2008
"1078",82,"Togo",0,0,1,1,2008
"1079",82,"Venezuela",0,0,1,1,2008
"1080",1,"United States",48,26,30,104,2012
"1081",2,"China",39,31,22,92,2012
"1082",3,"Great Britain",29,18,18,65,2012
"1083",4,"Russia",18,21,26,65,2012
"1084",5,"South Korea",13,9,9,31,2012
"1085",6,"Germany",11,20,13,44,2012
"1086",7,"France",11,11,13,35,2012
"1087",8,"Australia",8,15,12,35,2012
"1088",9,"Italy",8,9,11,28,2012
"1089",10,"Hungary",8,4,6,18,2012
"1090",11,"Japan",7,14,17,38,2012
"1091",12,"Iran",7,5,1,13,2012
"1092",13,"Netherlands",6,6,8,20,2012
"1093",14,"New Zealand",6,2,5,13,2012
"1094",15,"Ukraine",5,4,10,19,2012
"1095",16,"Cuba",5,3,7,15,2012
"1096",17,"Spain",4,10,6,20,2012
"1097",18,"Jamaica",4,5,4,13,2012
"1098",19,"Czech Republic",4,4,3,11,2012
"1099",20,"South Africa",4,1,1,6,2012
"1100",21,"North Korea",4,0,2,6,2012
"1101",22,"Brazil",3,5,9,17,2012
"1102",23,"Kazakhstan",3,2,6,11,2012
"1103",23,"Poland",3,2,6,11,2012
"1104",25,"Ethiopia",3,2,3,8,2012
"1105",26,"Croatia",3,1,2,6,2012
"1106",27,"Canada",2,6,10,18,2012
"1107",28,"Belarus",2,5,3,10,2012
"1108",29,"Kenya",2,4,7,13,2012
"1109",30,"Denmark",2,4,3,9,2012
"1110",31,"Romania",2,4,1,7,2012
"1111",32,"Azerbaijan",2,2,5,9,2012
"1112",33,"Switzerland",2,2,0,4,2012
"1113",34,"Norway",2,1,1,4,2012
"1114",35,"Lithuania",2,0,3,5,2012
"1115",36,"Tunisia",2,0,1,3,2012
"1116",37,"Sweden",1,4,3,8,2012
"1117",38,"Colombia",1,3,5,9,2012
"1118",39,"Mexico",1,3,4,8,2012
"1119",40,"Georgia",1,2,3,6,2012
"1120",41,"Ireland",1,1,4,6,2012
"1121",42,"Argentina",1,1,2,4,2012
"1122",42,"Serbia",1,1,2,4,2012
"1123",42,"Slovenia",1,1,2,4,2012
"1124",42,"Trinidad and Tobago",1,1,2,4,2012
"1125",46,"Turkey",1,1,1,3,2012
"1126",47,"Dominican Republic",1,1,0,2,2012
"1127",48,"Chinese Taipei",1,0,1,2,2012
"1128",48,"Latvia",1,0,1,2,2012
"1129",50,"Algeria",1,0,0,1,2012
"1130",50,"Bahamas",1,0,0,1,2012
"1131",50,"Bahrain",1,0,0,1,2012
"1132",50,"Grenada",1,0,0,1,2012
"1133",50,"Uganda",1,0,0,1,2012
"1134",50,"Venezuela",1,0,0,1,2012
"1135",56,"Egypt",0,3,1,4,2012
"1136",57,"India",0,2,4,6,2012
"1137",58,"Mongolia",0,2,3,5,2012
"1138",59,"Thailand",0,2,2,4,2012
"1139",60,"Bulgaria",0,2,1,3,2012
"1140",60,"Finland",0,2,1,3,2012
"1141",60,"Indonesia",0,2,1,3,2012
"1142",63,"Slovakia",0,1,3,4,2012
"1143",64,"Belgium",0,1,2,3,2012
"1144",65,"Armenia",0,1,1,2,2012
"1145",65,"Estonia",0,1,1,2,2012
"1146",65,"Malaysia",0,1,1,2,2012
"1147",65,"Puerto Rico",0,1,1,2,2012
"1148",65,"Qatar",0,1,1,2,2012
"1149",70,"Botswana",0,1,0,1,2012
"1150",70,"Cyprus",0,1,0,1,2012
"1151",70,"Gabon",0,1,0,1,2012
"1152",70,"Guatemala",0,1,0,1,2012
"1153",70,"Montenegro",0,1,0,1,2012
"1154",70,"Portugal",0,1,0,1,2012
"1155",76,"Uzbekistan",0,0,3,3,2012
"1156",77,"Greece",0,0,2,2,2012
"1157",77,"Singapore",0,0,2,2,2012
"1158",79,"Afghanistan",0,0,1,1,2012
"1159",79,"Cameroon",0,0,1,1,2012
"1160",79,"Hong Kong",0,0,1,1,2012
"1161",79,"Kuwait",0,0,1,1,2012
"1162",79,"Morocco",0,0,1,1,2012
"1163",79,"Saudi Arabia",0,0,1,1,2012
"1164",79,"Tajikistan",0,0,1,1,2012
"1165",79,"Vietnam",0,0,1,1,2012
"1166",1,"United States",46,37,38,121,2016
"1167",2,"Great Britain",27,23,17,67,2016
"1168",3,"China",26,18,26,70,2016
"1169",4,"Russia",19,17,20,56,2016
"1170",5,"Germany",17,10,15,42,2016
"1171",6,"Japan",12,8,21,41,2016
"1172",7,"France",10,18,14,42,2016
"1173",8,"South Korea",9,3,9,21,2016
"1174",9,"Italy",8,12,8,28,2016
"1175",10,"Australia",8,11,10,29,2016
"1176",11,"Netherlands",8,7,4,19,2016
"1177",12,"Hungary",8,3,4,15,2016
"1178",13,"Brazil",7,6,6,19,2016
"1179",14,"Spain",7,4,6,17,2016
"1180",15,"Kenya",6,6,1,13,2016
"1181",16,"Jamaica",6,3,2,11,2016
"1182",17,"Croatia",5,3,2,10,2016
"1183",18,"Cuba",5,2,4,11,2016
"1184",19,"New Zealand",4,9,5,18,2016
"1185",20,"Canada",4,3,15,22,2016
"1186",21,"Uzbekistan",4,2,7,13,2016
"1187",22,"Colombia",3,2,3,8,2016
"1188",23,"Switzerland",3,2,2,7,2016
"1189",24,"Iran",3,1,4,8,2016
"1190",25,"Greece",3,1,2,6,2016
"1191",26,"Argentina",3,1,0,4,2016
"1192",27,"Denmark",2,6,7,15,2016
"1193",28,"Sweden",2,6,3,11,2016
"1194",29,"South Africa",2,6,2,10,2016
"1195",30,"Kazakhstan",2,5,10,17,2016
"1196",31,"Ukraine",2,5,4,11,2016
"1197",32,"Serbia",2,4,2,8,2016
"1198",33,"Poland",2,3,6,11,2016
"1199",34,"North Korea",2,3,2,7,2016
"1200",35,"Belgium",2,2,2,6,2016
"1201",35,"Thailand",2,2,2,6,2016
"1202",37,"Slovakia",2,2,0,4,2016
"1203",38,"Georgia",2,1,4,7,2016
"1204",39,"Azerbaijan",1,7,10,18,2016
"1205",40,"Belarus",1,4,4,9,2016
"1206",41,"Turkey",1,3,4,8,2016
"1207",42,"Armenia",1,3,0,4,2016
"1208",43,"Czech Republic",1,2,7,10,2016
"1209",44,"Ethiopia",1,2,5,8,2016
"1210",45,"Slovenia",1,2,1,4,2016
"1211",46,"Indonesia",1,2,0,3,2016
"1212",47,"Romania",1,1,2,4,2016
"1213",48,"Bahrain",1,1,0,2,2016
"1214",48,"Vietnam",1,1,0,2,2016
"1215",50,"Chinese Taipei",1,0,2,3,2016
"1216",51,"Bahamas",1,0,1,2,2016
"1217",51,"Independent Olympic Athletes",1,0,1,2,2016
"1218",51,"Ivory Coast",1,0,1,2,2016
"1219",54,"Fiji",1,0,0,1,2016
"1220",54,"Jordan",1,0,0,1,2016
"1221",54,"Kosovo",1,0,0,1,2016
"1222",54,"Puerto Rico",1,0,0,1,2016
"1223",54,"Singapore",1,0,0,1,2016
"1224",54,"Tajikistan",1,0,0,1,2016
"1225",60,"Malaysia",0,4,1,5,2016
"1226",61,"Mexico",0,3,2,5,2016
"1227",62,"Venezuela",0,2,1,3,2016
"1228",63,"Algeria",0,2,0,2,2016
"1229",63,"Ireland",0,2,0,2,2016
"1230",65,"Lithuania",0,1,3,4,2016
"1231",66,"Bulgaria",0,1,2,3,2016
"1232",67,"India",0,1,1,2,2016
"1233",67,"Mongolia",0,1,1,2,2016
"1234",69,"Burundi",0,1,0,1,2016
"1235",69,"Grenada",0,1,0,1,2016
"1236",69,"Niger",0,1,0,1,2016
"1237",69,"Philippines",0,1,0,1,2016
"1238",69,"Qatar",0,1,0,1,2016
"1239",74,"Norway",0,0,4,4,2016
"1240",75,"Egypt",0,0,3,3,2016
"1241",75,"Tunisia",0,0,3,3,2016
"1242",77,"Israel",0,0,2,2,2016
"1243",78,"Austria",0,0,1,1,2016
"1244",78,"Dominican Republic",0,0,1,1,2016
"1245",78,"Estonia",0,0,1,1,2016
"1246",78,"Finland",0,0,1,1,2016
"1247",78,"Morocco",0,0,1,1,2016
"1248",78,"Nigeria",0,0,1,1,2016
"1249",78,"Portugal",0,0,1,1,2016
"1250",78,"Trinidad and Tobago",0,0,1,1,2016
"1251",78,"United Arab Emirates",0,0,1,1,2016
"1252",1,"United States",39,41,33,113,2020
"1253",2,"China",38,32,19,89,2020
"1254",3,"Japan",27,14,17,58,2020
"1255",4,"Great Britain",22,20,22,64,2020
"1256",5,"ROC",20,28,23,71,2020
"1257",6,"Australia",17,7,22,46,2020
"1258",7,"Netherlands",10,12,14,36,2020
"1259",8,"France",10,12,11,33,2020
"1260",9,"Germany",10,11,16,37,2020
"1261",10,"Italy",10,10,20,40,2020
"1262",11,"Canada",7,7,10,24,2020
"1263",12,"Brazil",7,6,8,21,2020
"1264",13,"New Zealand",7,6,7,20,2020
"1265",14,"Cuba",7,3,5,15,2020
"1266",15,"Hungary",6,7,7,20,2020
"1267",16,"South Korea",6,4,10,20,2020
"1268",17,"Poland",4,5,5,14,2020
"1269",18,"Czech Republic",4,4,3,11,2020
"1270",19,"Kenya",4,4,2,10,2020
"1271",20,"Norway",4,2,2,8,2020
"1272",21,"Jamaica",4,1,4,9,2020
"1273",22,"Spain",3,8,6,17,2020
"1274",23,"Sweden",3,6,0,9,2020
"1275",24,"Switzerland",3,4,6,13,2020
"1276",25,"Denmark",3,4,4,11,2020
"1277",26,"Croatia",3,3,2,8,2020
"1278",27,"Iran",3,2,2,7,2020
"1279",28,"Serbia",3,1,5,9,2020
"1280",29,"Belgium",3,1,3,7,2020
"1281",30,"Bulgaria",3,1,2,6,2020
"1282",31,"Slovenia",3,1,1,5,2020
"1283",32,"Uzbekistan",3,0,2,5,2020
"1284",33,"Georgia",2,5,1,8,2020
"1285",34,"Chinese Taipei",2,4,6,12,2020
"1286",35,"Turkey",2,2,9,13,2020
"1287",36,"Greece",2,1,1,4,2020
"1288",36,"Uganda",2,1,1,4,2020
"1289",38,"Ecuador",2,1,0,3,2020
"1290",39,"Ireland",2,0,2,4,2020
"1291",39,"Israel",2,0,2,4,2020
"1292",41,"Qatar",2,0,1,3,2020
"1293",42,"Bahamas",2,0,0,2,2020
"1294",42,"Kosovo",2,0,0,2,2020
"1295",44,"Ukraine",1,6,12,19,2020
"1296",45,"Belarus",1,3,3,7,2020
"1297",46,"Romania",1,3,0,4,2020
"1298",46,"Venezuela",1,3,0,4,2020
"1299",48,"India",1,2,4,7,2020
"1300",49,"Hong Kong",1,2,3,6,2020
"1301",50,"Philippines",1,2,1,4,2020
"1302",50,"Slovakia",1,2,1,4,2020
"1303",52,"South Africa",1,2,0,3,2020
"1304",53,"Austria",1,1,5,7,2020
"1305",54,"Egypt",1,1,4,6,2020
"1306",55,"Indonesia",1,1,3,5,2020
"1307",56,"Ethiopia",1,1,2,4,2020
"1308",56,"Portugal",1,1,2,4,2020
"1309",58,"Tunisia",1,1,0,2,2020
"1310",59,"Estonia",1,0,1,2,2020
"1311",59,"Fiji",1,0,1,2,2020
"1312",59,"Latvia",1,0,1,2,2020
"1313",59,"Thailand",1,0,1,2,2020
"1314",63,"Bermuda",1,0,0,1,2020
"1315",63,"Morocco",1,0,0,1,2020
"1316",63,"Puerto Rico",1,0,0,1,2020
"1317",66,"Colombia",0,4,1,5,2020
"1318",67,"Azerbaijan",0,3,4,7,2020
"1319",68,"Dominican Republic",0,3,2,5,2020
"1320",69,"Armenia",0,2,2,4,2020
"1321",70,"Kyrgyzstan",0,2,1,3,2020
"1322",71,"Mongolia",0,1,3,4,2020
"1323",72,"Argentina",0,1,2,3,2020
"1324",72,"San Marino",0,1,2,3,2020
"1325",74,"Jordan",0,1,1,2,2020
"1326",74,"Malaysia",0,1,1,2,2020
"1327",74,"Nigeria",0,1,1,2,2020
"1328",77,"Bahrain",0,1,0,1,2020
"1329",77,"Lithuania",0,1,0,1,2020
"1330",77,"Namibia",0,1,0,1,2020
"1331",77,"North Macedonia",0,1,0,1,2020
"1332",77,"Saudi Arabia",0,1,0,1,2020
"1333",77,"Turkmenistan",0,1,0,1,2020
"1334",83,"Kazakhstan",0,0,8,8,2020
"1335",84,"Mexico",0,0,4,4,2020
"1336",85,"Finland",0,0,2,2,2020
"1337",86,"Botswana",0,0,1,1,2020
"1338",86,"Burkina Faso",0,0,1,1,2020
"1339",86,"Ghana",0,0,1,1,2020
"1340",86,"Grenada",0,0,1,1,2020
"1341",86,"Ivory Coast",0,0,1,1,2020
"1342",86,"Kuwait",0,0,1,1,2020
"1343",86,"Moldova",0,0,1,1,2020
"1344",86,"Syria",0,0,1,1,2020
"1345",1,"United States",40,44,42,126,2024
"1346",2,"China",40,27,24,91,2024
"1347",3,"Japan",20,12,13,45,2024
"1348",4,"Australia",18,19,16,53,2024
"1349",5,"France",16,26,22,64,2024
"1350",6,"Netherlands",15,7,12,34,2024
"1351",7,"Great Britain",14,22,29,65,2024
"1352",8,"South Korea",13,9,10,32,2024
"1353",9,"Italy",12,13,15,40,2024
"1354",10,"Germany",12,13,8,33,2024
"1355",11,"New Zealand",10,7,3,20,2024
"1356",12,"Canada",9,7,11,27,2024
"1357",13,"Uzbekistan",8,2,3,13,2024
"1358",14,"Hungary",6,7,6,19,2024
"1359",15,"Spain",5,4,9,18,2024
"1360",16,"Sweden",4,4,3,11,2024
"1361",17,"Kenya",4,2,5,11,2024
"1362",18,"Norway",4,1,3,8,2024
"1363",19,"Ireland",4,0,3,7,2024
"1364",20,"Brazil",3,7,10,20,2024
"1365",21,"Iran",3,6,3,12,2024
"1366",22,"Ukraine",3,5,4,12,2024
"1367",23,"Romania",3,4,2,9,2024
"1368",24,"Georgia",3,3,1,7,2024
"1369",25,"Belgium",3,1,6,10,2024
"1370",26,"Bulgaria",3,1,3,7,2024
"1371",27,"Serbia",3,1,1,5,2024
"1372",28,"Czech Republic",3,0,2,5,2024
"1373",29,"Denmark",2,2,5,9,2024
"1374",30,"Azerbaijan",2,2,3,7,2024
"1375",30,"Croatia",2,2,3,7,2024
"1376",32,"Cuba",2,1,6,9,2024
"1377",33,"Bahrain",2,1,1,4,2024
"1378",34,"Slovenia",2,1,0,3,2024
"1379",35,"Chinese Taipei",2,0,5,7,2024
"1380",36,"Austria",2,0,3,5,2024
"1381",37,"Hong Kong",2,0,2,4,2024
"1382",37,"Philippines",2,0,2,4,2024
"1383",39,"Algeria",2,0,1,3,2024
"1384",39,"Indonesia",2,0,1,3,2024
"1385",41,"Israel",1,5,1,7,2024
"1386",42,"Poland",1,4,5,10,2024
"1387",43,"Kazakhstan",1,3,3,7,2024
"1388",44,"Jamaica",1,3,2,6,2024
"1389",44,"South Africa",1,3,2,6,2024
"1390",44,"Thailand",1,3,2,6,2024
"1391",47,"Ethiopia",1,3,0,4,2024
"1392",48,"Switzerland",1,2,5,8,2024
"1393",49,"Ecuador",1,2,2,5,2024
"1394",50,"Portugal",1,2,1,4,2024
"1395",51,"Greece",1,1,6,8,2024
"1396",52,"Argentina",1,1,1,3,2024
"1397",52,"Egypt",1,1,1,3,2024
"1398",52,"Tunisia",1,1,1,3,2024
"1399",55,"Botswana",1,1,0,2,2024
"1400",55,"Chile",1,1,0,2,2024
"1401",55,"Saint Lucia",1,1,0,2,2024
"1402",55,"Uganda",1,1,0,2,2024
"1403",59,"Dominican Republic",1,0,2,3,2024
"1404",60,"Guatemala",1,0,1,2,2024
"1405",60,"Morocco",1,0,1,2,2024
"1406",62,"Dominica",1,0,0,1,2024
"1407",62,"Pakistan",1,0,0,1,2024
"1408",64,"Turkey",0,3,5,8,2024
"1409",65,"Mexico",0,3,2,5,2024
"1410",66,"Armenia",0,3,1,4,2024
"1411",66,"Colombia",0,3,1,4,2024
"1412",68,"Kyrgyzstan",0,2,4,6,2024
"1413",68,"North Korea",0,2,4,6,2024
"1414",70,"Lithuania",0,2,2,4,2024
"1415",71,"India",0,1,5,6,2024
"1416",72,"Moldova",0,1,3,4,2024
"1417",73,"Kosovo",0,1,1,2,2024
"1418",74,"Cyprus",0,1,0,1,2024
"1419",74,"Fiji",0,1,0,1,2024
"1420",74,"Jordan",0,1,0,1,2024
"1421",74,"Mongolia",0,1,0,1,2024
"1422",74,"Panama",0,1,0,1,2024
"1423",79,"Tajikistan",0,0,3,3,2024
"1424",80,"Albania",0,0,2,2,2024
"1425",80,"Grenada",0,0,2,2,2024
"1426",80,"Malaysia",0,0,2,2,2024
"1427",80,"Puerto Rico",0,0,2,2,2024
"1428",84,"Cabo Verde",0,0,1,1,2024
"1429",84,"Ivory Coast",0,0,1,1,2024
"1430",84,"Peru",0,0,1,1,2024
"1431",84,"Qatar",0,0,1,1,2024
"1432",84,"Refugee Olympic Team",0,0,1,1,2024
"1433",84,"Singapore",0,0,1,1,2024
"1434",84,"Slovakia",0,0,1,1,2024
"1435",84,"Zambia",0,0,1,1,2024
