"","Rank","NOC","Gold","Silver","Bronze","Total","Year"
"1",1,"United States",41,27,27,95,1920
"2",2,"Sweden",19,20,25,64,1920
"3",3,"Finland",15,10,9,34,1920
"4",4,"Great Britain",14,15,13,42,1920
"5",5,"Belgium",14,11,11,36,1920
"6",6,"Norway",13,9,9,31,1920
"7",7,"Italy",13,5,5,23,1920
"8",8,"France",9,19,13,41,1920
"9",9,"Netherlands",4,2,5,11,1920
"10",10,"Denmark",3,9,1,13,1920
"11",11,"South Africa",3,4,3,10,1920
"12",12,"Canada",3,3,3,9,1920
"13",13,"Switzerland",2,2,7,11,1920
"14",14,"Estonia",1,2,0,3,1920
"15",15,"Brazil",1,1,1,3,1920
"16",16,"Australia",0,2,1,3,1920
"17",17,"Japan",0,2,0,2,1920
"18",17,"Spain",0,2,0,2,1920
"19",19,"Greece",0,1,0,1,1920
"20",19,"Luxembourg",0,1,0,1,1920
"21",21,"Czechoslovakia",0,0,2,2,1920
"22",22,"New Zealand",0,0,1,1,1920
"23",1,"United States",45,27,27,99,1924
"24",2,"Finland",14,13,10,37,1924
"25",3,"France",13,15,10,38,1924
"26",4,"Great Britain",9,13,12,34,1924
"27",5,"Italy",8,3,5,16,1924
"28",6,"Switzerland",7,8,10,25,1924
"29",7,"Norway",5,2,3,10,1924
"30",8,"Sweden",4,13,12,29,1924
"31",9,"Netherlands",4,1,5,10,1924
"32",10,"Belgium",3,7,3,13,1924
"33",11,"Australia",3,1,2,6,1924
"34",12,"Denmark",2,5,2,9,1924
"35",13,"Hungary",2,3,4,9,1924
"36",14,"Yugoslavia",2,0,0,2,1924
"37",15,"Czechoslovakia",1,4,5,10,1924
"38",16,"Argentina",1,3,2,6,1924
"39",17,"Estonia",1,1,4,6,1924
"40",18,"South Africa",1,1,1,3,1924
"41",19,"Uruguay",1,0,0,1,1924
"42",20,"Austria",0,3,1,4,1924
"43",20,"Canada",0,3,1,4,1924
"44",22,"Poland",0,1,1,2,1924
"45",23,"Haiti",0,0,1,1,1924
"46",23,"Japan",0,0,1,1,1924
"47",23,"New Zealand",0,0,1,1,1924
"48",23,"Portugal",0,0,1,1,1924
"49",23,"Romania",0,0,1,1,1924
"50",1,"United States",22,18,16,56,1928
"51",2,"Germany",10,7,14,31,1928
"52",3,"Finland",8,8,9,25,1928
"53",4,"Sweden",7,6,12,25,1928
"54",5,"Italy",7,5,7,19,1928
"55",6,"Switzerland",7,4,4,15,1928
"56",7,"France",6,10,5,21,1928
"57",8,"Netherlands",6,9,4,19,1928
"58",9,"Hungary",4,5,0,9,1928
"59",10,"Canada",4,4,7,15,1928
"60",11,"Great Britain",3,10,7,20,1928
"61",12,"Argentina",3,3,1,7,1928
"62",13,"Denmark",3,1,2,6,1928
"63",14,"Czechoslovakia",2,5,2,9,1928
"64",15,"Japan",2,2,1,5,1928
"65",16,"Estonia",2,1,2,5,1928
"66",17,"Egypt",2,1,1,4,1928
"67",18,"Austria",2,0,1,3,1928
"68",19,"Australia",1,2,1,4,1928
"69",19,"Norway",1,2,1,4,1928
"70",21,"Poland",1,1,3,5,1928
"71",21,"Yugoslavia",1,1,3,5,1928
"72",23,"South Africa",1,0,2,3,1928
"73",24,"India",1,0,0,1,1928
"74",24,"Ireland",1,0,0,1,1928
"75",24,"New Zealand",1,0,0,1,1928
"76",24,"Spain",1,0,0,1,1928
"77",24,"Uruguay",1,0,0,1,1928
"78",29,"Belgium",0,1,2,3,1928
"79",30,"Chile",0,1,0,1,1928
"80",30,"Haiti",0,1,0,1,1928
"81",32,"Philippines",0,0,1,1,1928
"82",32,"Portugal",0,0,1,1,1928
"83",1,"United States",44,36,30,110,1932
"84",2,"Italy",12,12,12,36,1932
"85",3,"France",11,5,4,20,1932
"86",4,"Sweden",10,5,9,24,1932
"87",5,"Japan",7,7,4,18,1932
"88",6,"Hungary",6,5,5,16,1932
"89",7,"Germany",5,12,7,24,1932
"90",8,"Finland",5,8,12,25,1932
"91",9,"Great Britain",5,7,5,17,1932
"92",10,"Poland",3,2,4,9,1932
"93",11,"Australia",3,1,1,5,1932
"94",12,"Argentina",3,1,0,4,1932
"95",13,"Canada",2,5,9,16,1932
"96",14,"Netherlands",2,5,1,8,1932
"97",15,"South Africa",2,0,3,5,1932
"98",16,"Ireland",2,0,0,2,1932
"99",17,"Czechoslovakia",1,3,2,6,1932
"100",18,"Austria",1,1,3,5,1932
"101",19,"India",1,0,0,1,1932
"102",20,"Denmark",0,5,3,8,1932
"103",21,"Mexico",0,2,0,2,1932
"104",22,"Latvia",0,1,0,1,1932
"105",22,"New Zealand",0,1,0,1,1932
"106",22,"Switzerland",0,1,0,1,1932
"107",25,"Philippines",0,0,3,3,1932
"108",26,"Belgium",0,0,1,1,1932
"109",26,"Spain",0,0,1,1,1932
"110",26,"Uruguay",0,0,1,1,1932
"111",1,"Germany",38,31,32,101,1936
"112",2,"United States",24,21,12,57,1936
"113",3,"Hungary",10,1,5,16,1936
"114",4,"Italy",9,13,5,27,1936
"115",5,"Finland",8,6,6,20,1936
"116",6,"France",7,6,6,19,1936
"117",7,"Sweden",6,5,10,21,1936
"118",8,"Japan",6,4,10,20,1936
"119",9,"Netherlands",6,4,7,17,1936
"120",10,"Austria",5,7,5,17,1936
"121",11,"Switzerland",4,9,5,18,1936
"122",12,"Great Britain",4,7,3,14,1936
"123",13,"Czechoslovakia",3,5,1,9,1936
"124",14,"Argentina",2,2,3,7,1936
"125",14,"Estonia",2,2,3,7,1936
"126",16,"Egypt",2,1,2,5,1936
"127",17,"Canada",1,3,5,9,1936
"128",18,"Norway",1,3,2,6,1936
"129",19,"Turkey",1,0,1,2,1936
"130",20,"India",1,0,0,1,1936
"131",20,"New Zealand",1,0,0,1,1936
"132",22,"Poland",0,4,5,9,1936
"133",23,"Denmark",0,2,3,5,1936
"134",24,"Latvia",0,1,1,2,1936
"135",25,"Romania",0,1,0,1,1936
"136",25,"South Africa",0,1,0,1,1936
"137",25,"Yugoslavia",0,1,0,1,1936
"138",28,"Belgium",0,0,3,3,1936
"139",28,"Mexico",0,0,3,3,1936
"140",30,"Australia",0,0,1,1,1936
"141",30,"Philippines",0,0,1,1,1936
"142",30,"Portugal",0,0,1,1,1936
"143",1,"United States",38,27,19,84,1948
"144",2,"Sweden",16,11,17,44,1948
"145",3,"France",10,6,13,29,1948
"146",4,"Hungary",10,5,12,27,1948
"147",5,"Italy",8,11,8,27,1948
"148",6,"Finland",8,7,5,20,1948
"149",7,"Turkey",6,4,2,12,1948
"150",8,"Czechoslovakia",6,2,3,11,1948
"151",9,"Switzerland",5,10,5,20,1948
"152",10,"Denmark",5,7,8,20,1948
"153",11,"Netherlands",5,2,9,16,1948
"154",12,"Great Britain",3,14,6,23,1948
"155",13,"Argentina",3,3,1,7,1948
"156",14,"Australia",2,6,5,13,1948
"157",15,"Belgium",2,2,3,7,1948
"158",16,"Egypt",2,2,1,5,1948
"159",17,"Mexico",2,1,2,5,1948
"160",18,"South Africa",2,1,1,4,1948
"161",19,"Norway",1,3,3,7,1948
"162",20,"Jamaica",1,2,0,3,1948
"163",21,"Austria",1,0,3,4,1948
"164",22,"India",1,0,0,1,1948
"165",22,"Peru",1,0,0,1,1948
"166",24,"Yugoslavia",0,2,0,2,1948
"167",25,"Canada",0,1,2,3,1948
"168",26,"Portugal",0,1,1,2,1948
"169",26,"Uruguay",0,1,1,2,1948
"170",28,"Ceylon",0,1,0,1,1948
"171",28,"Cuba",0,1,0,1,1948
"172",28,"Spain",0,1,0,1,1948
"173",28,"Trinidad and Tobago",0,1,0,1,1948
"174",32,"Panama",0,0,2,2,1948
"175",32,"South Korea",0,0,2,2,1948
"176",34,"Brazil",0,0,1,1,1948
"177",34,"Iran",0,0,1,1,1948
"178",34,"Poland",0,0,1,1,1948
"179",34,"Puerto Rico",0,0,1,1,1948
"180",1,"United States",40,19,17,76,1952
"181",2,"Soviet Union",22,30,19,71,1952
"182",3,"Hungary",16,10,16,42,1952
"183",4,"Sweden",12,13,10,35,1952
"184",5,"Italy",8,9,4,21,1952
"185",6,"Czechoslovakia",7,3,3,13,1952
"186",7,"France",6,6,6,18,1952
"187",8,"Finland",6,3,13,22,1952
"188",9,"Australia",6,2,3,11,1952
"189",10,"Norway",3,2,0,5,1952
"190",11,"Switzerland",2,6,6,14,1952
"191",12,"South Africa",2,4,4,10,1952
"192",13,"Jamaica",2,3,0,5,1952
"193",14,"Belgium",2,2,0,4,1952
"194",15,"Denmark",2,1,3,6,1952
"195",16,"Turkey",2,0,1,3,1952
"196",17,"Japan",1,6,2,9,1952
"197",18,"Great Britain",1,2,8,11,1952
"198",19,"Argentina",1,2,2,5,1952
"199",20,"Poland",1,2,1,4,1952
"200",21,"Canada",1,2,0,3,1952
"201",21,"Yugoslavia",1,2,0,3,1952
"202",23,"Romania",1,1,2,4,1952
"203",24,"Brazil",1,0,2,3,1952
"204",24,"New Zealand",1,0,2,3,1952
"205",26,"India",1,0,1,2,1952
"206",27,"Luxembourg",1,0,0,1,1952
"207",28,"Germany",0,7,17,24,1952
"208",29,"Netherlands",0,5,0,5,1952
"209",30,"Iran",0,3,4,7,1952
"210",31,"Chile",0,2,0,2,1952
"211",32,"Austria",0,1,1,2,1952
"212",32,"Lebanon",0,1,1,2,1952
"213",34,"Ireland",0,1,0,1,1952
"214",34,"Mexico",0,1,0,1,1952
"215",34,"Spain",0,1,0,1,1952
"216",37,"South Korea",0,0,2,2,1952
"217",37,"Trinidad and Tobago",0,0,2,2,1952
"218",37,"Uruguay",0,0,2,2,1952
"219",40,"Bulgaria",0,0,1,1,1952
"220",40,"Egypt",0,0,1,1,1952
"221",40,"Portugal",0,0,1,1,1952
"222",40,"Venezuela",0,0,1,1,1952
"223",1,"Soviet Union",37,29,32,98,1956
"224",2,"United States",32,25,17,74,1956
"225",3,"Australia",13,8,14,35,1956
"226",4,"Hungary",9,10,7,26,1956
"227",5,"Italy",8,8,9,25,1956
"228",6,"Sweden",8,5,6,19,1956
"229",7,"United Team of Germany",6,13,7,26,1956
"230",8,"Great Britain",6,7,11,24,1956
"231",9,"Romania",5,3,5,13,1956
"232",10,"Japan",4,10,5,19,1956
"233",11,"France",4,4,6,14,1956
"234",12,"Turkey",3,2,2,7,1956
"235",13,"Finland",3,1,11,15,1956
"236",14,"Iran",2,2,1,5,1956
"237",15,"Canada",2,1,3,6,1956
"238",16,"New Zealand",2,0,0,2,1956
"239",17,"Poland",1,4,4,9,1956
"240",18,"Czechoslovakia",1,4,1,6,1956
"241",19,"Bulgaria",1,3,1,5,1956
"242",20,"Denmark",1,2,1,4,1956
"243",21,"Ireland",1,1,3,5,1956
"244",22,"Norway",1,0,2,3,1956
"245",23,"Mexico",1,0,1,2,1956
"246",24,"Brazil",1,0,0,1,1956
"247",24,"India",1,0,0,1,1956
"248",26,"Yugoslavia",0,3,0,3,1956
"249",27,"Chile",0,2,2,4,1956
"250",28,"Belgium",0,2,0,2,1956
"251",29,"Argentina",0,1,1,2,1956
"252",29,"South Korea",0,1,1,2,1956
"253",31,"Iceland",0,1,0,1,1956
"254",31,"Pakistan",0,1,0,1,1956
"255",33,"South Africa",0,0,4,4,1956
"256",34,"Austria",0,0,2,2,1956
"257",35,"Bahamas",0,0,1,1,1956
"258",35,"Greece",0,0,1,1,1956
"259",35,"Switzerland",0,0,1,1,1956
"260",35,"Uruguay",0,0,1,1,1956
"261",1,"Soviet Union",43,29,31,103,1960
"262",2,"United States",34,21,16,71,1960
"263",3,"Italy",13,10,13,36,1960
"264",4,"United Team of Germany",12,19,11,42,1960
"265",5,"Australia",8,8,6,22,1960
"266",6,"Turkey",7,2,0,9,1960
"267",7,"Hungary",6,8,7,21,1960
"268",8,"Japan",4,7,7,18,1960
"269",9,"Poland",4,6,11,21,1960
"270",10,"Czechoslovakia",3,2,3,8,1960
"271",11,"Romania",3,1,6,10,1960
"272",12,"Great Britain",2,6,12,20,1960
"273",13,"Denmark",2,3,1,6,1960
"274",14,"New Zealand",2,0,1,3,1960
"275",15,"Bulgaria",1,3,3,7,1960
"276",16,"Sweden",1,2,3,6,1960
"277",17,"Finland",1,1,3,5,1960
"278",18,"Austria",1,1,0,2,1960
"279",18,"Yugoslavia",1,1,0,2,1960
"280",20,"Pakistan",1,0,1,2,1960
"281",21,"Ethiopia",1,0,0,1,1960
"282",21,"Greece",1,0,0,1,1960
"283",21,"Norway",1,0,0,1,1960
"284",24,"Switzerland",0,3,3,6,1960
"285",25,"France",0,2,3,5,1960
"286",26,"Belgium",0,2,2,4,1960
"287",27,"Iran",0,1,3,4,1960
"288",28,"Netherlands",0,1,2,3,1960
"289",28,"South Africa",0,1,2,3,1960
"290",30,"Argentina",0,1,1,2,1960
"291",30,"Egypt",0,1,1,2,1960
"292",32,"Canada",0,1,0,1,1960
"293",32,"Formosa",0,1,0,1,1960
"294",32,"Ghana",0,1,0,1,1960
"295",32,"India",0,1,0,1,1960
"296",32,"Morocco",0,1,0,1,1960
"297",32,"Portugal",0,1,0,1,1960
"298",32,"Singapore",0,1,0,1,1960
"299",39,"Brazil",0,0,2,2,1960
"300",39,"British West Indies",0,0,2,2,1960
"301",41,"Iraq",0,0,1,1,1960
"302",41,"Mexico",0,0,1,1,1960
"303",41,"Spain",0,0,1,1,1960
"304",41,"Venezuela",0,0,1,1,1960
"305",1,"United States",36,26,28,90,1964
"306",2,"Soviet Union",30,31,35,96,1964
"307",3,"Japan",16,5,8,29,1964
"308",4,"United Team of Germany",10,22,18,50,1964
"309",5,"Italy",10,10,7,27,1964
"310",6,"Hungary",10,7,5,22,1964
"311",7,"Poland",7,6,10,23,1964
"312",8,"Australia",6,2,10,18,1964
"313",9,"Czechoslovakia",5,6,3,14,1964
"314",10,"Great Britain",4,12,2,18,1964
"315",11,"Bulgaria",3,5,2,10,1964
"316",12,"Finland",3,0,2,5,1964
"317",12,"New Zealand",3,0,2,5,1964
"318",14,"Romania",2,4,6,12,1964
"319",15,"Netherlands",2,4,4,10,1964
"320",16,"Turkey",2,3,1,6,1964
"321",17,"Sweden",2,2,4,8,1964
"322",18,"Denmark",2,1,3,6,1964
"323",19,"Yugoslavia",2,1,2,5,1964
"324",20,"Belgium",2,0,1,3,1964
"325",21,"France",1,8,6,15,1964
"326",22,"Canada",1,2,1,4,1964
"327",22,"Switzerland",1,2,1,4,1964
"328",24,"Bahamas",1,0,0,1,1964
"329",24,"Ethiopia",1,0,0,1,1964
"330",24,"India",1,0,0,1,1964
"331",27,"South Korea",0,2,1,3,1964
"332",28,"Trinidad and Tobago",0,1,2,3,1964
"333",29,"Tunisia",0,1,1,2,1964
"334",30,"Argentina",0,1,0,1,1964
"335",30,"Cuba",0,1,0,1,1964
"336",30,"Pakistan",0,1,0,1,1964
"337",30,"Philippines",0,1,0,1,1964
"338",34,"Iran",0,0,2,2,1964
"339",35,"Brazil",0,0,1,1,1964
"340",35,"Ghana",0,0,1,1,1964
"341",35,"Ireland",0,0,1,1,1964
"342",35,"Kenya",0,0,1,1,1964
"343",35,"Mexico",0,0,1,1,1964
"344",35,"Nigeria",0,0,1,1,1964
"345",35,"Uruguay",0,0,1,1,1964
"346",1,"United States",45,28,34,107,1968
"347",2,"Soviet Union",29,32,30,91,1968
"348",3,"Japan",11,7,7,25,1968
"349",4,"Hungary",10,10,12,32,1968
"350",5,"East Germany",9,9,7,25,1968
"351",6,"France",7,3,5,15,1968
"352",7,"Czechoslovakia",7,2,4,13,1968
"353",8,"West Germany",5,11,10,26,1968
"354",9,"Australia",5,7,5,17,1968
"355",10,"Great Britain",5,5,3,13,1968
"356",11,"Poland",5,2,11,18,1968
"357",12,"Romania",4,6,5,15,1968
"358",13,"Italy",3,4,9,16,1968
"359",14,"Kenya",3,4,2,9,1968
"360",15,"Mexico",3,3,3,9,1968
"361",16,"Yugoslavia",3,3,2,8,1968
"362",17,"Netherlands",3,3,1,7,1968
"363",18,"Bulgaria",2,4,3,9,1968
"364",19,"Iran",2,1,2,5,1968
"365",20,"Sweden",2,1,1,4,1968
"366",21,"Turkey",2,0,0,2,1968
"367",22,"Denmark",1,4,3,8,1968
"368",23,"Canada",1,3,1,5,1968
"369",24,"Finland",1,2,1,4,1968
"370",25,"Ethiopia",1,1,0,2,1968
"371",25,"Norway",1,1,0,2,1968
"372",27,"New Zealand",1,0,2,3,1968
"373",28,"Tunisia",1,0,1,2,1968
"374",29,"Pakistan",1,0,0,1,1968
"375",29,"Venezuela",1,0,0,1,1968
"376",31,"Cuba",0,4,0,4,1968
"377",32,"Austria",0,2,2,4,1968
"378",33,"Switzerland",0,1,4,5,1968
"379",34,"Mongolia",0,1,3,4,1968
"380",35,"Brazil",0,1,2,3,1968
"381",36,"Belgium",0,1,1,2,1968
"382",36,"South Korea",0,1,1,2,1968
"383",36,"Uganda",0,1,1,2,1968
"384",39,"Cameroon",0,1,0,1,1968
"385",39,"Jamaica",0,1,0,1,1968
"386",41,"Argentina",0,0,2,2,1968
"387",42,"Greece",0,0,1,1,1968
"388",42,"India",0,0,1,1,1968
"389",42,"Taiwan",0,0,1,1,1968
"390",1,"Soviet Union",50,27,22,99,1972
"391",2,"United States",33,31,30,94,1972
"392",3,"East Germany",20,23,23,66,1972
"393",4,"West Germany",13,11,16,40,1972
"394",5,"Japan",13,8,8,29,1972
"395",6,"Australia",8,7,2,17,1972
"396",7,"Poland",7,5,9,21,1972
"397",8,"Hungary",6,13,16,35,1972
"398",9,"Bulgaria",6,10,5,21,1972
"399",10,"Italy",5,3,10,18,1972
"400",11,"Sweden",4,6,6,16,1972
"401",12,"Great Britain",4,5,9,18,1972
"402",13,"Romania",3,6,7,16,1972
"403",14,"Cuba",3,1,4,8,1972
"404",14,"Finland",3,1,4,8,1972
"405",16,"Netherlands",3,1,1,5,1972
"406",17,"France",2,4,7,13,1972
"407",18,"Czechoslovakia",2,4,2,8,1972
"408",19,"Kenya",2,3,4,9,1972
"409",20,"Yugoslavia",2,1,2,5,1972
"410",21,"Norway",2,1,1,4,1972
"411",22,"North Korea",1,1,3,5,1972
"412",23,"New Zealand",1,1,1,3,1972
"413",24,"Uganda",1,1,0,2,1972
"414",25,"Denmark",1,0,0,1,1972
"415",26,"Switzerland",0,3,0,3,1972
"416",27,"Canada",0,2,3,5,1972
"417",28,"Iran",0,2,1,3,1972
"418",29,"Belgium",0,2,0,2,1972
"419",29,"Greece",0,2,0,2,1972
"420",31,"Austria",0,1,2,3,1972
"421",31,"Colombia",0,1,2,3,1972
"422",33,"Argentina",0,1,0,1,1972
"423",33,"Lebanon",0,1,0,1,1972
"424",33,"Mexico",0,1,0,1,1972
"425",33,"Mongolia",0,1,0,1,1972
"426",33,"Pakistan",0,1,0,1,1972
"427",33,"South Korea",0,1,0,1,1972
"428",33,"Tunisia",0,1,0,1,1972
"429",33,"Turkey",0,1,0,1,1972
"430",41,"Brazil",0,0,2,2,1972
"431",41,"Ethiopia",0,0,2,2,1972
"432",43,"Ghana",0,0,1,1,1972
"433",43,"India",0,0,1,1,1972
"434",43,"Jamaica",0,0,1,1,1972
"435",43,"Niger",0,0,1,1,1972
"436",43,"Nigeria",0,0,1,1,1972
"437",43,"Spain",0,0,1,1,1972
"438",1,"Soviet Union",49,41,35,125,1976
"439",2,"East Germany",40,25,25,90,1976
"440",3,"United States",34,35,25,94,1976
"441",4,"West Germany",10,12,17,39,1976
"442",5,"Japan",9,6,10,25,1976
"443",6,"Poland",7,6,13,26,1976
"444",7,"Bulgaria",6,9,7,22,1976
"445",8,"Cuba",6,4,3,13,1976
"446",9,"Romania",4,9,14,27,1976
"447",10,"Hungary",4,5,13,22,1976
"448",11,"Finland",4,2,0,6,1976
"449",12,"Sweden",4,1,0,5,1976
"450",13,"Great Britain",3,5,5,13,1976
"451",14,"Italy",2,7,4,13,1976
"452",15,"France",2,3,4,9,1976
"453",16,"Yugoslavia",2,3,3,8,1976
"454",17,"Czechoslovakia",2,2,4,8,1976
"455",18,"New Zealand",2,1,1,4,1976
"456",19,"South Korea",1,1,4,6,1976
"457",20,"Switzerland",1,1,2,4,1976
"458",21,"Jamaica",1,1,0,2,1976
"459",21,"North Korea",1,1,0,2,1976
"460",21,"Norway",1,1,0,2,1976
"461",24,"Denmark",1,0,2,3,1976
"462",25,"Mexico",1,0,1,2,1976
"463",26,"Trinidad and Tobago",1,0,0,1,1976
"464",27,"Canada",0,5,6,11,1976
"465",28,"Belgium",0,3,3,6,1976
"466",29,"Netherlands",0,2,3,5,1976
"467",30,"Portugal",0,2,0,2,1976
"468",30,"Spain",0,2,0,2,1976
"469",32,"Australia",0,1,4,5,1976
"470",33,"Iran",0,1,1,2,1976
"471",34,"Mongolia",0,1,0,1,1976
"472",34,"Venezuela",0,1,0,1,1976
"473",36,"Brazil",0,0,2,2,1976
"474",37,"Austria",0,0,1,1,1976
"475",37,"Bermuda",0,0,1,1,1976
"476",37,"Pakistan",0,0,1,1,1976
"477",37,"Puerto Rico",0,0,1,1,1976
"478",37,"Thailand",0,0,1,1,1976
"479",1,"Soviet Union",80,69,46,195,1980
"480",2,"East Germany",47,37,42,126,1980
"481",3,"Bulgaria",8,16,17,41,1980
"482",4,"Cuba",8,7,5,20,1980
"483",5,"Italy",8,3,4,15,1980
"484",6,"Hungary",7,10,15,32,1980
"485",7,"Romania",6,6,13,25,1980
"486",8,"France",6,5,3,14,1980
"487",9,"Great Britain",5,7,9,21,1980
"488",10,"Poland",3,14,15,32,1980
"489",11,"Sweden",3,3,6,12,1980
"490",12,"Finland",3,1,4,8,1980
"491",13,"Czechoslovakia",2,3,9,14,1980
"492",14,"Yugoslavia",2,3,4,9,1980
"493",15,"Australia",2,2,5,9,1980
"494",16,"Denmark",2,1,2,5,1980
"495",17,"Brazil",2,0,2,4,1980
"496",17,"Ethiopia",2,0,2,4,1980
"497",19,"Switzerland",2,0,0,2,1980
"498",20,"Spain",1,3,2,6,1980
"499",21,"Austria",1,2,1,4,1980
"500",22,"Greece",1,0,2,3,1980
"501",23,"Belgium",1,0,0,1,1980
"502",23,"India",1,0,0,1,1980
"503",23,"Zimbabwe",1,0,0,1,1980
"504",26,"North Korea",0,3,2,5,1980
"505",27,"Mongolia",0,2,2,4,1980
"506",28,"Tanzania",0,2,0,2,1980
"507",29,"Mexico",0,1,3,4,1980
"508",30,"Netherlands",0,1,2,3,1980
"509",31,"Ireland",0,1,1,2,1980
"510",32,"Uganda",0,1,0,1,1980
"511",32,"Venezuela",0,1,0,1,1980
"512",34,"Jamaica",0,0,3,3,1980
"513",35,"Guyana",0,0,1,1,1980
"514",35,"Lebanon",0,0,1,1,1980
"515",1,"United States",83,61,30,174,1984
"516",2,"Romania",20,16,17,53,1984
"517",3,"West Germany",17,19,23,59,1984
"518",4,"China",15,8,9,32,1984
"519",5,"Italy",14,6,12,32,1984
"520",6,"Canada",10,18,16,44,1984
"521",7,"Japan",10,8,14,32,1984
"522",8,"New Zealand",8,1,2,11,1984
"523",9,"Yugoslavia",7,4,7,18,1984
"524",10,"South Korea",6,6,7,19,1984
"525",11,"Great Britain",5,11,21,37,1984
"526",12,"France",5,7,16,28,1984
"527",13,"Netherlands",5,2,6,13,1984
"528",14,"Australia",4,8,12,24,1984
"529",15,"Finland",4,2,6,12,1984
"530",16,"Sweden",2,11,6,19,1984
"531",17,"Mexico",2,3,1,6,1984
"532",18,"Morocco",2,0,0,2,1984
"533",19,"Brazil",1,5,2,8,1984
"534",20,"Spain",1,2,2,5,1984
"535",21,"Belgium",1,1,2,4,1984
"536",22,"Austria",1,1,1,3,1984
"537",23,"Kenya",1,0,2,3,1984
"538",23,"Portugal",1,0,2,3,1984
"539",25,"Pakistan",1,0,0,1,1984
"540",26,"Switzerland",0,4,4,8,1984
"541",27,"Denmark",0,3,3,6,1984
"542",28,"Jamaica",0,1,2,3,1984
"543",28,"Norway",0,1,2,3,1984
"544",30,"Greece",0,1,1,2,1984
"545",30,"Nigeria",0,1,1,2,1984
"546",30,"Puerto Rico",0,1,1,2,1984
"547",33,"Colombia",0,1,0,1,1984
"548",33,"Egypt",0,1,0,1,1984
"549",33,"Ireland",0,1,0,1,1984
"550",33,"Ivory Coast",0,1,0,1,1984
"551",33,"Peru",0,1,0,1,1984
"552",33,"Syria",0,1,0,1,1984
"553",33,"Thailand",0,1,0,1,1984
"554",40,"Turkey",0,0,3,3,1984
"555",40,"Venezuela",0,0,3,3,1984
"556",42,"Algeria",0,0,2,2,1984
"557",43,"Cameroon",0,0,1,1,1984
"558",43,"Chinese Taipei",0,0,1,1,1984
"559",43,"Dominican Republic",0,0,1,1,1984
"560",43,"Iceland",0,0,1,1,1984
"561",43,"Zambia",0,0,1,1,1984
"562",1,"Soviet Union",55,31,46,132,1988
"563",2,"East Germany",37,35,30,102,1988
"564",3,"United States",36,31,27,94,1988
"565",4,"South Korea",12,10,11,33,1988
"566",5,"West Germany",11,14,15,40,1988
"567",6,"Hungary",11,6,6,23,1988
"568",7,"Bulgaria",10,12,13,35,1988
"569",8,"Romania",7,11,6,24,1988
"570",9,"France",6,4,6,16,1988
"571",10,"Italy",6,4,4,14,1988
"572",11,"China",5,11,12,28,1988
"573",12,"Great Britain",5,10,9,24,1988
"574",13,"Kenya",5,2,2,9,1988
"575",14,"Japan",4,3,7,14,1988
"576",15,"Australia",3,6,5,14,1988
"577",16,"Yugoslavia",3,4,5,12,1988
"578",17,"Czechoslovakia",3,3,2,8,1988
"579",18,"New Zealand",3,2,8,13,1988
"580",19,"Canada",3,2,5,10,1988
"581",20,"Poland",2,5,9,16,1988
"582",21,"Norway",2,3,0,5,1988
"583",22,"Netherlands",2,2,5,9,1988
"584",23,"Denmark",2,1,1,4,1988
"585",24,"Brazil",1,2,3,6,1988
"586",25,"Finland",1,1,2,4,1988
"587",25,"Spain",1,1,2,4,1988
"588",27,"Turkey",1,1,0,2,1988
"589",28,"Morocco",1,0,2,3,1988
"590",29,"Austria",1,0,0,1,1988
"591",29,"Portugal",1,0,0,1,1988
"592",29,"Suriname",1,0,0,1,1988
"593",32,"Sweden",0,4,7,11,1988
"594",33,"Switzerland",0,2,2,4,1988
"595",34,"Jamaica",0,2,0,2,1988
"596",35,"Argentina",0,1,1,2,1988
"597",36,"Chile",0,1,0,1,1988
"598",36,"Costa Rica",0,1,0,1,1988
"599",36,"Indonesia",0,1,0,1,1988
"600",36,"Iran",0,1,0,1,1988
"601",36,"Netherlands Antilles",0,1,0,1,1988
"602",36,"Peru",0,1,0,1,1988
"603",36,"Senegal",0,1,0,1,1988
"604",36,"Virgin Islands",0,1,0,1,1988
"605",44,"Belgium",0,0,2,2,1988
"606",44,"Mexico",0,0,2,2,1988
"607",46,"Colombia",0,0,1,1,1988
"608",46,"Djibouti",0,0,1,1,1988
"609",46,"Greece",0,0,1,1,1988
"610",46,"Mongolia",0,0,1,1,1988
"611",46,"Pakistan",0,0,1,1,1988
"612",46,"Philippines",0,0,1,1,1988
"613",46,"Thailand",0,0,1,1,1988
"614",1,"Unified Team",45,38,29,112,1992
"615",2,"United States",37,34,37,108,1992
"616",3,"Germany",33,21,28,82,1992
"617",4,"China",16,22,16,54,1992
"618",5,"Cuba",14,6,11,31,1992
"619",6,"Spain",13,7,2,22,1992
"620",7,"South Korea",12,5,12,29,1992
"621",8,"Hungary",11,12,7,30,1992
"622",9,"France",8,5,16,29,1992
"623",10,"Australia",7,9,11,27,1992
"624",11,"Canada",7,4,7,18,1992
"625",12,"Italy",6,5,8,19,1992
"626",13,"Great Britain",5,3,12,20,1992
"627",14,"Romania",4,6,8,18,1992
"628",15,"Czechoslovakia",4,2,1,7,1992
"629",16,"North Korea",4,0,5,9,1992
"630",17,"Japan",3,8,11,22,1992
"631",18,"Bulgaria",3,7,6,16,1992
"632",19,"Poland",3,6,10,19,1992
"633",20,"Netherlands",2,6,7,15,1992
"634",21,"Kenya",2,4,2,8,1992
"635",22,"Norway",2,4,1,7,1992
"636",23,"Turkey",2,2,2,6,1992
"637",24,"Indonesia",2,2,1,5,1992
"638",25,"Brazil",2,1,0,3,1992
"639",26,"Greece",2,0,0,2,1992
"640",27,"Sweden",1,7,4,12,1992
"641",28,"New Zealand",1,4,5,10,1992
"642",29,"Finland",1,2,2,5,1992
"643",30,"Denmark",1,1,4,6,1992
"644",31,"Morocco",1,1,1,3,1992
"645",32,"Ireland",1,1,0,2,1992
"646",33,"Ethiopia",1,0,2,3,1992
"647",34,"Algeria",1,0,1,2,1992
"648",34,"Estonia",1,0,1,2,1992
"649",34,"Lithuania",1,0,1,2,1992
"650",37,"Switzerland",1,0,0,1,1992
"651",38,"Jamaica",0,3,1,4,1992
"652",38,"Nigeria",0,3,1,4,1992
"653",40,"Latvia",0,2,1,3,1992
"654",41,"Austria",0,2,0,2,1992
"655",41,"Namibia",0,2,0,2,1992
"656",41,"South Africa",0,2,0,2,1992
"657",44,"Belgium",0,1,2,3,1992
"658",44,"Croatia",0,1,2,3,1992
"659",44,"Independent Olympic Participants",0,1,2,3,1992
"660",44,"Iran",0,1,2,3,1992
"661",48,"Israel",0,1,1,2,1992
"662",49,"Chinese Taipei",0,1,0,1,1992
"663",49,"Mexico",0,1,0,1,1992
"664",49,"Peru",0,1,0,1,1992
"665",52,"Mongolia",0,0,2,2,1992
"666",52,"Slovenia",0,0,2,2,1992
"667",54,"Argentina",0,0,1,1,1992
"668",54,"Bahamas",0,0,1,1,1992
"669",54,"Colombia",0,0,1,1,1992
"670",54,"Ghana",0,0,1,1,1992
"671",54,"Malaysia",0,0,1,1,1992
"672",54,"Pakistan",0,0,1,1,1992
"673",54,"Philippines",0,0,1,1,1992
"674",54,"Puerto Rico",0,0,1,1,1992
"675",54,"Qatar",0,0,1,1,1992
"676",54,"Suriname",0,0,1,1,1992
"677",54,"Thailand",0,0,1,1,1992
"678",1,"United States",44,32,25,101,1996
"679",2,"Russia",26,21,16,63,1996
"680",3,"Germany",20,18,27,65,1996
"681",4,"China",16,22,12,50,1996
"682",5,"France",15,7,15,37,1996
"683",6,"Italy",13,10,12,35,1996
"684",7,"Australia",9,9,23,41,1996
"685",8,"Cuba",9,8,8,25,1996
"686",9,"Ukraine",9,2,12,23,1996
"687",10,"South Korea",7,15,5,27,1996
"688",11,"Poland",7,5,5,17,1996
"689",12,"Hungary",7,4,10,21,1996
"690",13,"Spain",5,6,6,17,1996
"691",14,"Romania",4,7,9,20,1996
"692",15,"Netherlands",4,5,10,19,1996
"693",16,"Greece",4,4,0,8,1996
"694",17,"Czech Republic",4,3,4,11,1996
"695",18,"Switzerland",4,3,0,7,1996
"696",19,"Denmark",4,1,1,6,1996
"697",19,"Turkey",4,1,1,6,1996
"698",21,"Canada",3,11,8,22,1996
"699",22,"Bulgaria",3,7,5,15,1996
"700",23,"Japan",3,6,5,14,1996
"701",24,"Kazakhstan",3,4,4,11,1996
"702",25,"Brazil",3,3,9,15,1996
"703",26,"New Zealand",3,2,1,6,1996
"704",27,"South Africa",3,1,1,5,1996
"705",28,"Ireland",3,0,1,4,1996
"706",29,"Sweden",2,4,2,8,1996
"707",30,"Norway",2,2,3,7,1996
"708",31,"Belgium",2,2,2,6,1996
"709",32,"Nigeria",2,1,3,6,1996
"710",33,"North Korea",2,1,2,5,1996
"711",34,"Algeria",2,0,1,3,1996
"712",34,"Ethiopia",2,0,1,3,1996
"713",36,"Great Britain",1,8,6,15,1996
"714",37,"Belarus",1,6,8,15,1996
"715",38,"Kenya",1,4,3,8,1996
"716",39,"Jamaica",1,3,2,6,1996
"717",40,"Finland",1,2,1,4,1996
"718",41,"FR Yugoslavia",1,1,2,4,1996
"719",41,"Indonesia",1,1,2,4,1996
"720",43,"Iran",1,1,1,3,1996
"721",43,"Slovakia",1,1,1,3,1996
"722",45,"Armenia",1,1,0,2,1996
"723",45,"Croatia",1,1,0,2,1996
"724",47,"Portugal",1,0,1,2,1996
"725",47,"Thailand",1,0,1,2,1996
"726",49,"Burundi",1,0,0,1,1996
"727",49,"Costa Rica",1,0,0,1,1996
"728",49,"Ecuador",1,0,0,1,1996
"729",49,"Hong Kong",1,0,0,1,1996
"730",49,"Syria",1,0,0,1,1996
"731",54,"Argentina",0,2,1,3,1996
"732",55,"Namibia",0,2,0,2,1996
"733",55,"Slovenia",0,2,0,2,1996
"734",57,"Austria",0,1,2,3,1996
"735",58,"Malaysia",0,1,1,2,1996
"736",58,"Moldova",0,1,1,2,1996
"737",58,"Uzbekistan",0,1,1,2,1996
"738",61,"Azerbaijan",0,1,0,1,1996
"739",61,"Bahamas",0,1,0,1,1996
"740",61,"Chinese Taipei",0,1,0,1,1996
"741",61,"Latvia",0,1,0,1,1996
"742",61,"Philippines",0,1,0,1,1996
"743",61,"Tonga",0,1,0,1,1996
"744",61,"Zambia",0,1,0,1,1996
"745",68,"Georgia",0,0,2,2,1996
"746",68,"Morocco",0,0,2,2,1996
"747",68,"Trinidad and Tobago",0,0,2,2,1996
"748",71,"India",0,0,1,1,1996
"749",71,"Israel",0,0,1,1,1996
"750",71,"Lithuania",0,0,1,1,1996
"751",71,"Mexico",0,0,1,1,1996
"752",71,"Mongolia",0,0,1,1,1996
"753",71,"Mozambique",0,0,1,1,1996
"754",71,"Puerto Rico",0,0,1,1,1996
"755",71,"Tunisia",0,0,1,1,1996
"756",71,"Uganda",0,0,1,1,1996
"757",1,"United States",37,24,32,93,2000
"758",2,"Russia",32,28,29,89,2000
"759",3,"China",28,16,14,58,2000
"760",4,"Australia",16,25,17,58,2000
"761",5,"Germany",13,17,26,56,2000
"762",6,"France",13,14,11,38,2000
"763",7,"Italy",13,8,13,34,2000
"764",8,"Netherlands",12,9,4,25,2000
"765",9,"Cuba",11,11,7,29,2000
"766",10,"Great Britain",11,10,7,28,2000
"767",11,"Romania",11,6,9,26,2000
"768",12,"South Korea",8,10,10,28,2000
"769",13,"Hungary",8,6,3,17,2000
"770",14,"Poland",6,5,3,14,2000
"771",15,"Japan",5,8,5,18,2000
"772",16,"Bulgaria",5,6,2,13,2000
"773",17,"Greece",4,6,3,13,2000
"774",18,"Sweden",4,5,3,12,2000
"775",19,"Norway",4,3,3,10,2000
"776",20,"Ethiopia",4,1,3,8,2000
"777",21,"Ukraine",3,10,10,23,2000
"778",22,"Kazakhstan",3,4,0,7,2000
"779",23,"Belarus",3,3,11,17,2000
"780",24,"Canada",3,3,8,14,2000
"781",25,"Spain",3,3,5,11,2000
"782",26,"Turkey",3,0,2,5,2000
"783",27,"Iran",3,0,1,4,2000
"784",28,"Czech Republic",2,3,3,8,2000
"785",29,"Kenya",2,3,2,7,2000
"786",30,"Denmark",2,3,1,6,2000
"787",31,"Finland",2,1,1,4,2000
"788",32,"Austria",2,1,0,3,2000
"789",33,"Lithuania",2,0,3,5,2000
"790",34,"Azerbaijan",2,0,1,3,2000
"791",34,"Bahamas",2,0,1,3,2000
"792",36,"Slovenia",2,0,0,2,2000
"793",37,"Switzerland",1,6,2,9,2000
"794",38,"Indonesia",1,3,2,6,2000
"795",39,"Slovakia",1,3,1,5,2000
"796",40,"Mexico",1,2,3,6,2000
"797",41,"Nigeria",1,2,0,3,2000
"798",42,"Algeria",1,1,3,5,2000
"799",43,"Uzbekistan",1,1,2,4,2000
"800",44,"FR Yugoslavia",1,1,1,3,2000
"801",44,"Latvia",1,1,1,3,2000
"802",46,"New Zealand",1,0,3,4,2000
"803",47,"Estonia",1,0,2,3,2000
"804",47,"Thailand",1,0,2,3,2000
"805",49,"Croatia",1,0,1,2,2000
"806",50,"Cameroon",1,0,0,1,2000
"807",50,"Colombia",1,0,0,1,2000
"808",50,"Mozambique",1,0,0,1,2000
"809",53,"Brazil",0,6,6,12,2000
"810",54,"Jamaica",0,6,3,9,2000
"811",55,"Belgium",0,2,3,5,2000
"812",55,"South Africa",0,2,3,5,2000
"813",57,"Argentina",0,2,2,4,2000
"814",58,"Chinese Taipei",0,1,4,5,2000
"815",58,"Morocco",0,1,4,5,2000
"816",60,"North Korea",0,1,3,4,2000
"817",61,"Moldova",0,1,1,2,2000
"818",61,"Saudi Arabia",0,1,1,2,2000
"819",61,"Trinidad and Tobago",0,1,1,2,2000
"820",64,"Ireland",0,1,0,1,2000
"821",64,"Sri Lanka",0,1,0,1,2000
"822",64,"Uruguay",0,1,0,1,2000
"823",64,"Vietnam",0,1,0,1,2000
"824",68,"Georgia",0,0,6,6,2000
"825",69,"Costa Rica",0,0,2,2,2000
"826",69,"Portugal",0,0,2,2,2000
"827",71,"Armenia",0,0,1,1,2000
"828",71,"Barbados",0,0,1,1,2000
"829",71,"Chile",0,0,1,1,2000
"830",71,"Iceland",0,0,1,1,2000
"831",71,"India",0,0,1,1,2000
"832",71,"Israel",0,0,1,1,2000
"833",71,"Kuwait",0,0,1,1,2000
"834",71,"Kyrgyzstan",0,0,1,1,2000
"835",71,"Macedonia",0,0,1,1,2000
"836",71,"Qatar",0,0,1,1,2000
"837",1,"United States",36,39,26,101,2004
"838",2,"China",32,17,14,63,2004
"839",3,"Russia",28,26,36,90,2004
"840",4,"Australia",17,16,17,50,2004
"841",5,"Japan",16,9,12,37,2004
"842",6,"Germany",13,16,20,49,2004
"843",7,"France",11,9,13,33,2004
"844",8,"Italy",10,11,11,32,2004
"845",9,"South Korea",9,12,9,30,2004
"846",10,"Great Britain",9,9,12,30,2004
"847",11,"Cuba",9,7,11,27,2004
"848",12,"Hungary",8,6,3,17,2004
"849",13,"Ukraine",8,5,9,22,2004
"850",14,"Romania",8,5,6,19,2004
"851",15,"Greece",6,6,4,16,2004
"852",16,"Brazil",5,2,3,10,2004
"853",17,"Norway",5,0,1,6,2004
"854",18,"Netherlands",4,9,9,22,2004
"855",19,"Sweden",4,2,1,7,2004
"856",20,"Spain",3,11,6,20,2004
"857",21,"Canada",3,6,3,12,2004
"858",22,"Turkey",3,3,4,10,2004
"859",23,"Poland",3,2,5,10,2004
"860",24,"New Zealand",3,2,0,5,2004
"861",25,"Thailand",3,1,4,8,2004
"862",26,"Belarus",2,5,6,13,2004
"863",27,"Austria",2,4,1,7,2004
"864",28,"Ethiopia",2,3,2,7,2004
"865",29,"Iran",2,2,2,6,2004
"866",29,"Slovakia",2,2,2,6,2004
"867",31,"Chinese Taipei",2,2,1,5,2004
"868",32,"Georgia",2,2,0,4,2004
"869",33,"Bulgaria",2,1,9,12,2004
"870",34,"Denmark",2,1,5,8,2004
"871",35,"Jamaica",2,1,2,5,2004
"872",35,"Uzbekistan",2,1,2,5,2004
"873",37,"Morocco",2,1,0,3,2004
"874",38,"Argentina",2,0,4,6,2004
"875",39,"Chile",2,0,1,3,2004
"876",40,"Kazakhstan",1,4,3,8,2004
"877",41,"Kenya",1,4,2,7,2004
"878",42,"Czech Republic",1,3,5,9,2004
"879",43,"South Africa",1,3,2,6,2004
"880",44,"Croatia",1,2,2,5,2004
"881",45,"Lithuania",1,2,0,3,2004
"882",46,"Egypt",1,1,3,5,2004
"883",46,"Switzerland",1,1,3,5,2004
"884",48,"Indonesia",1,1,2,4,2004
"885",49,"Zimbabwe",1,1,1,3,2004
"886",50,"Azerbaijan",1,0,4,5,2004
"887",51,"Belgium",1,0,2,3,2004
"888",52,"Bahamas",1,0,1,2,2004
"889",52,"Israel",1,0,1,2,2004
"890",54,"Cameroon",1,0,0,1,2004
"891",54,"Dominican Republic",1,0,0,1,2004
"892",54,"United Arab Emirates",1,0,0,1,2004
"893",57,"North Korea",0,4,1,5,2004
"894",58,"Latvia",0,4,0,4,2004
"895",59,"Mexico",0,3,1,4,2004
"896",60,"Portugal",0,2,1,3,2004
"897",61,"Finland",0,2,0,2,2004
"898",61,"Serbia and Montenegro",0,2,0,2,2004
"899",63,"Slovenia",0,1,3,4,2004
"900",64,"Estonia",0,1,2,3,2004
"901",65,"Hong Kong",0,1,0,1,2004
"902",65,"India",0,1,0,1,2004
"903",65,"Paraguay",0,1,0,1,2004
"904",68,"Colombia",0,0,2,2,2004
"905",68,"Nigeria",0,0,2,2,2004
"906",68,"Venezuela",0,0,2,2,2004
"907",71,"Eritrea",0,0,1,1,2004
"908",71,"Mongolia",0,0,1,1,2004
"909",71,"Syria",0,0,1,1,2004
"910",71,"Trinidad and Tobago",0,0,1,1,2004
"911",1,"China",48,22,30,100,2008
"912",2,"United States",36,39,37,112,2008
"913",3,"Russia",24,13,23,60,2008
"914",4,"Great Britain",19,13,19,51,2008
"915",5,"Germany",16,11,14,41,2008
"916",6,"Australia",14,15,17,46,2008
"917",7,"South Korea",13,11,8,32,2008
"918",8,"Japan",9,8,8,25,2008
"919",9,"Italy",8,9,10,27,2008
"920",10,"France",7,16,20,43,2008
"921",11,"Netherlands",7,5,4,16,2008
"922",12,"Ukraine",7,4,11,22,2008
"923",13,"Kenya",6,4,6,16,2008
"924",14,"Spain",5,11,3,19,2008
"925",15,"Jamaica",5,4,2,11,2008
"926",16,"Poland",4,5,2,11,2008
"927",17,"Ethiopia",4,2,1,7,2008
"928",18,"Romania",4,1,4,9,2008
"929",19,"Cuba",3,10,17,30,2008
"930",20,"Canada",3,9,8,20,2008
"931",21,"Hungary",3,5,2,10,2008
"932",22,"Norway",3,5,1,9,2008
"933",23,"Brazil",3,4,10,17,2008
"934",24,"Belarus",3,4,7,14,2008
"935",25,"Czech Republic",3,3,1,7,2008
"936",26,"Slovakia",3,3,0,6,2008
"937",27,"New Zealand",3,2,4,9,2008
"938",28,"Georgia",3,2,2,7,2008
"939",29,"Kazakhstan",2,3,4,9,2008
"940",30,"Denmark",2,2,3,7,2008
"941",31,"North Korea",2,2,2,6,2008
"942",31,"Thailand",2,2,2,6,2008
"943",33,"Mongolia",2,2,0,4,2008
"944",34,"Switzerland",2,1,4,7,2008
"945",35,"Argentina",2,0,4,6,2008
"946",36,"Mexico",2,0,2,4,2008
"947",37,"Belgium",2,0,0,2,2008
"948",38,"Zimbabwe",1,3,0,4,2008
"949",39,"Slovenia",1,2,2,5,2008
"950",40,"Azerbaijan",1,1,4,6,2008
"951",40,"Indonesia",1,1,4,6,2008
"952",42,"Bulgaria",1,1,3,5,2008
"953",42,"Turkey",1,1,3,5,2008
"954",44,"Chinese Taipei",1,1,2,4,2008
"955",44,"Finland",1,1,2,4,2008
"956",46,"Latvia",1,1,1,3,2008
"957",47,"Dominican Republic",1,1,0,2,2008
"958",47,"Estonia",1,1,0,2,2008
"959",47,"Portugal",1,1,0,2,2008
"960",47,"Trinidad and Tobago",1,1,0,2,2008
"961",51,"India",1,0,2,3,2008
"962",52,"Iran",1,0,1,2,2008
"963",53,"Cameroon",1,0,0,1,2008
"964",53,"Panama",1,0,0,1,2008
"965",53,"Tunisia",1,0,0,1,2008
"966",56,"Sweden",0,4,1,5,2008
"967",57,"Lithuania",0,3,2,5,2008
"968",57,"Nigeria",0,3,2,5,2008
"969",59,"Croatia",0,2,3,5,2008
"970",60,"Colombia",0,2,1,3,2008
"971",60,"Greece",0,2,1,3,2008
"972",62,"Armenia",0,1,4,5,2008
"973",63,"Uzbekistan",0,1,3,4,2008
"974",64,"Austria",0,1,2,3,2008
"975",64,"Ireland",0,1,2,3,2008
"976",64,"Kyrgyzstan",0,1,2,3,2008
"977",64,"Serbia",0,1,2,3,2008
"978",68,"Algeria",0,1,1,2,2008
"979",68,"Bahamas",0,1,1,2,2008
"980",68,"Morocco",0,1,1,2,2008
"981",68,"Tajikistan",0,1,1,2,2008
"982",72,"Chile",0,1,0,1,2008
"983",72,"Ecuador",0,1,0,1,2008
"984",72,"Iceland",0,1,0,1,2008
"985",72,"Malaysia",0,1,0,1,2008
"986",72,"Samoa",0,1,0,1,2008
"987",72,"Singapore",0,1,0,1,2008
"988",72,"South Africa",0,1,0,1,2008
"989",72,"Sudan",0,1,0,1,2008
"990",72,"Vietnam",0,1,0,1,2008
"991",81,"Egypt",0,0,2,2,2008
"992",82,"Afghanistan",0,0,1,1,2008
"993",82,"Israel",0,0,1,1,2008
"994",82,"Mauritius",0,0,1,1,2008
"995",82,"Moldova",0,0,1,1,2008
"996",82,"Togo",0,0,1,1,2008
"997",82,"Venezuela",0,0,1,1,2008
"998",1,"United States",48,26,30,104,2012
"999",2,"China",39,31,22,92,2012
"1000",3,"Great Britain",29,18,18,65,2012
"1001",4,"Russia",18,21,26,65,2012
"1002",5,"South Korea",13,9,9,31,2012
"1003",6,"Germany",11,20,13,44,2012
"1004",7,"France",11,11,13,35,2012
"1005",8,"Australia",8,15,12,35,2012
"1006",9,"Italy",8,9,11,28,2012
"1007",10,"Hungary",8,4,6,18,2012
"1008",11,"Japan",7,14,17,38,2012
"1009",12,"Iran",7,5,1,13,2012
"1010",13,"Netherlands",6,6,8,20,2012
"1011",14,"New Zealand",6,2,5,13,2012
"1012",15,"Ukraine",5,4,10,19,2012
"1013",16,"Cuba",5,3,7,15,2012
"1014",17,"Spain",4,10,6,20,2012
"1015",18,"Jamaica",4,5,4,13,2012
"1016",19,"Czech Republic",4,4,3,11,2012
"1017",20,"South Africa",4,1,1,6,2012
"1018",21,"North Korea",4,0,2,6,2012
"1019",22,"Brazil",3,5,9,17,2012
"1020",23,"Kazakhstan",3,2,6,11,2012
"1021",23,"Poland",3,2,6,11,2012
"1022",25,"Ethiopia",3,2,3,8,2012
"1023",26,"Croatia",3,1,2,6,2012
"1024",27,"Canada",2,6,10,18,2012
"1025",28,"Belarus",2,5,3,10,2012
"1026",29,"Kenya",2,4,7,13,2012
"1027",30,"Denmark",2,4,3,9,2012
"1028",31,"Romania",2,4,1,7,2012
"1029",32,"Azerbaijan",2,2,5,9,2012
"1030",33,"Switzerland",2,2,0,4,2012
"1031",34,"Norway",2,1,1,4,2012
"1032",35,"Lithuania",2,0,3,5,2012
"1033",36,"Tunisia",2,0,1,3,2012
"1034",37,"Sweden",1,4,3,8,2012
"1035",38,"Colombia",1,3,5,9,2012
"1036",39,"Mexico",1,3,4,8,2012
"1037",40,"Georgia",1,2,3,6,2012
"1038",41,"Ireland",1,1,4,6,2012
"1039",42,"Argentina",1,1,2,4,2012
"1040",42,"Serbia",1,1,2,4,2012
"1041",42,"Slovenia",1,1,2,4,2012
"1042",42,"Trinidad and Tobago",1,1,2,4,2012
"1043",46,"Turkey",1,1,1,3,2012
"1044",47,"Dominican Republic",1,1,0,2,2012
"1045",48,"Chinese Taipei",1,0,1,2,2012
"1046",48,"Latvia",1,0,1,2,2012
"1047",50,"Algeria",1,0,0,1,2012
"1048",50,"Bahamas",1,0,0,1,2012
"1049",50,"Bahrain",1,0,0,1,2012
"1050",50,"Grenada",1,0,0,1,2012
"1051",50,"Uganda",1,0,0,1,2012
"1052",50,"Venezuela",1,0,0,1,2012
"1053",56,"Egypt",0,3,1,4,2012
"1054",57,"India",0,2,4,6,2012
"1055",58,"Mongolia",0,2,3,5,2012
"1056",59,"Thailand",0,2,2,4,2012
"1057",60,"Bulgaria",0,2,1,3,2012
"1058",60,"Finland",0,2,1,3,2012
"1059",60,"Indonesia",0,2,1,3,2012
"1060",63,"Slovakia",0,1,3,4,2012
"1061",64,"Belgium",0,1,2,3,2012
"1062",65,"Armenia",0,1,1,2,2012
"1063",65,"Estonia",0,1,1,2,2012
"1064",65,"Malaysia",0,1,1,2,2012
"1065",65,"Puerto Rico",0,1,1,2,2012
"1066",65,"Qatar",0,1,1,2,2012
"1067",70,"Botswana",0,1,0,1,2012
"1068",70,"Cyprus",0,1,0,1,2012
"1069",70,"Gabon",0,1,0,1,2012
"1070",70,"Guatemala",0,1,0,1,2012
"1071",70,"Montenegro",0,1,0,1,2012
"1072",70,"Portugal",0,1,0,1,2012
"1073",76,"Uzbekistan",0,0,3,3,2012
"1074",77,"Greece",0,0,2,2,2012
"1075",77,"Singapore",0,0,2,2,2012
"1076",79,"Afghanistan",0,0,1,1,2012
"1077",79,"Cameroon",0,0,1,1,2012
"1078",79,"Hong Kong",0,0,1,1,2012
"1079",79,"Kuwait",0,0,1,1,2012
"1080",79,"Morocco",0,0,1,1,2012
"1081",79,"Saudi Arabia",0,0,1,1,2012
"1082",79,"Tajikistan",0,0,1,1,2012
"1083",79,"Vietnam",0,0,1,1,2012
"1084",1,"United States",46,37,38,121,2016
"1085",2,"Great Britain",27,23,17,67,2016
"1086",3,"China",26,18,26,70,2016
"1087",4,"Russia",19,17,20,56,2016
"1088",5,"Germany",17,10,15,42,2016
"1089",6,"Japan",12,8,21,41,2016
"1090",7,"France",10,18,14,42,2016
"1091",8,"South Korea",9,3,9,21,2016
"1092",9,"Italy",8,12,8,28,2016
"1093",10,"Australia",8,11,10,29,2016
"1094",11,"Netherlands",8,7,4,19,2016
"1095",12,"Hungary",8,3,4,15,2016
"1096",13,"Brazil",7,6,6,19,2016
"1097",14,"Spain",7,4,6,17,2016
"1098",15,"Kenya",6,6,1,13,2016
"1099",16,"Jamaica",6,3,2,11,2016
"1100",17,"Croatia",5,3,2,10,2016
"1101",18,"Cuba",5,2,4,11,2016
"1102",19,"New Zealand",4,9,5,18,2016
"1103",20,"Canada",4,3,15,22,2016
"1104",21,"Uzbekistan",4,2,7,13,2016
"1105",22,"Colombia",3,2,3,8,2016
"1106",23,"Switzerland",3,2,2,7,2016
"1107",24,"Iran",3,1,4,8,2016
"1108",25,"Greece",3,1,2,6,2016
"1109",26,"Argentina",3,1,0,4,2016
"1110",27,"Denmark",2,6,7,15,2016
"1111",28,"Sweden",2,6,3,11,2016
"1112",29,"South Africa",2,6,2,10,2016
"1113",30,"Kazakhstan",2,5,10,17,2016
"1114",31,"Ukraine",2,5,4,11,2016
"1115",32,"Serbia",2,4,2,8,2016
"1116",33,"Poland",2,3,6,11,2016
"1117",34,"North Korea",2,3,2,7,2016
"1118",35,"Belgium",2,2,2,6,2016
"1119",35,"Thailand",2,2,2,6,2016
"1120",37,"Slovakia",2,2,0,4,2016
"1121",38,"Georgia",2,1,4,7,2016
"1122",39,"Azerbaijan",1,7,10,18,2016
"1123",40,"Belarus",1,4,4,9,2016
"1124",41,"Turkey",1,3,4,8,2016
"1125",42,"Armenia",1,3,0,4,2016
"1126",43,"Czech Republic",1,2,7,10,2016
"1127",44,"Ethiopia",1,2,5,8,2016
"1128",45,"Slovenia",1,2,1,4,2016
"1129",46,"Indonesia",1,2,0,3,2016
"1130",47,"Romania",1,1,2,4,2016
"1131",48,"Bahrain",1,1,0,2,2016
"1132",48,"Vietnam",1,1,0,2,2016
"1133",50,"Chinese Taipei",1,0,2,3,2016
"1134",51,"Bahamas",1,0,1,2,2016
"1135",51,"Independent Olympic Athletes",1,0,1,2,2016
"1136",51,"Ivory Coast",1,0,1,2,2016
"1137",54,"Fiji",1,0,0,1,2016
"1138",54,"Jordan",1,0,0,1,2016
"1139",54,"Kosovo",1,0,0,1,2016
"1140",54,"Puerto Rico",1,0,0,1,2016
"1141",54,"Singapore",1,0,0,1,2016
"1142",54,"Tajikistan",1,0,0,1,2016
"1143",60,"Malaysia",0,4,1,5,2016
"1144",61,"Mexico",0,3,2,5,2016
"1145",62,"Venezuela",0,2,1,3,2016
"1146",63,"Algeria",0,2,0,2,2016
"1147",63,"Ireland",0,2,0,2,2016
"1148",65,"Lithuania",0,1,3,4,2016
"1149",66,"Bulgaria",0,1,2,3,2016
"1150",67,"India",0,1,1,2,2016
"1151",67,"Mongolia",0,1,1,2,2016
"1152",69,"Burundi",0,1,0,1,2016
"1153",69,"Grenada",0,1,0,1,2016
"1154",69,"Niger",0,1,0,1,2016
"1155",69,"Philippines",0,1,0,1,2016
"1156",69,"Qatar",0,1,0,1,2016
"1157",74,"Norway",0,0,4,4,2016
"1158",75,"Egypt",0,0,3,3,2016
"1159",75,"Tunisia",0,0,3,3,2016
"1160",77,"Israel",0,0,2,2,2016
"1161",78,"Austria",0,0,1,1,2016
"1162",78,"Dominican Republic",0,0,1,1,2016
"1163",78,"Estonia",0,0,1,1,2016
"1164",78,"Finland",0,0,1,1,2016
"1165",78,"Morocco",0,0,1,1,2016
"1166",78,"Nigeria",0,0,1,1,2016
"1167",78,"Portugal",0,0,1,1,2016
"1168",78,"Trinidad and Tobago",0,0,1,1,2016
"1169",78,"United Arab Emirates",0,0,1,1,2016
"1170",1,"United States",39,41,33,113,2020
"1171",2,"China",38,32,19,89,2020
"1172",3,"Japan",27,14,17,58,2020
"1173",4,"Great Britain",22,20,22,64,2020
"1174",5,"ROC",20,28,23,71,2020
"1175",6,"Australia",17,7,22,46,2020
"1176",7,"Netherlands",10,12,14,36,2020
"1177",8,"France",10,12,11,33,2020
"1178",9,"Germany",10,11,16,37,2020
"1179",10,"Italy",10,10,20,40,2020
"1180",11,"Canada",7,7,10,24,2020
"1181",12,"Brazil",7,6,8,21,2020
"1182",13,"New Zealand",7,6,7,20,2020
"1183",14,"Cuba",7,3,5,15,2020
"1184",15,"Hungary",6,7,7,20,2020
"1185",16,"South Korea",6,4,10,20,2020
"1186",17,"Poland",4,5,5,14,2020
"1187",18,"Czech Republic",4,4,3,11,2020
"1188",19,"Kenya",4,4,2,10,2020
"1189",20,"Norway",4,2,2,8,2020
"1190",21,"Jamaica",4,1,4,9,2020
"1191",22,"Spain",3,8,6,17,2020
"1192",23,"Sweden",3,6,0,9,2020
"1193",24,"Switzerland",3,4,6,13,2020
"1194",25,"Denmark",3,4,4,11,2020
"1195",26,"Croatia",3,3,2,8,2020
"1196",27,"Iran",3,2,2,7,2020
"1197",28,"Serbia",3,1,5,9,2020
"1198",29,"Belgium",3,1,3,7,2020
"1199",30,"Bulgaria",3,1,2,6,2020
"1200",31,"Slovenia",3,1,1,5,2020
"1201",32,"Uzbekistan",3,0,2,5,2020
"1202",33,"Georgia",2,5,1,8,2020
"1203",34,"Chinese Taipei",2,4,6,12,2020
"1204",35,"Turkey",2,2,9,13,2020
"1205",36,"Greece",2,1,1,4,2020
"1206",36,"Uganda",2,1,1,4,2020
"1207",38,"Ecuador",2,1,0,3,2020
"1208",39,"Ireland",2,0,2,4,2020
"1209",39,"Israel",2,0,2,4,2020
"1210",41,"Qatar",2,0,1,3,2020
"1211",42,"Bahamas",2,0,0,2,2020
"1212",42,"Kosovo",2,0,0,2,2020
"1213",44,"Ukraine",1,6,12,19,2020
"1214",45,"Belarus",1,3,3,7,2020
"1215",46,"Romania",1,3,0,4,2020
"1216",46,"Venezuela",1,3,0,4,2020
"1217",48,"India",1,2,4,7,2020
"1218",49,"Hong Kong",1,2,3,6,2020
"1219",50,"Philippines",1,2,1,4,2020
"1220",50,"Slovakia",1,2,1,4,2020
"1221",52,"South Africa",1,2,0,3,2020
"1222",53,"Austria",1,1,5,7,2020
"1223",54,"Egypt",1,1,4,6,2020
"1224",55,"Indonesia",1,1,3,5,2020
"1225",56,"Ethiopia",1,1,2,4,2020
"1226",56,"Portugal",1,1,2,4,2020
"1227",58,"Tunisia",1,1,0,2,2020
"1228",59,"Estonia",1,0,1,2,2020
"1229",59,"Fiji",1,0,1,2,2020
"1230",59,"Latvia",1,0,1,2,2020
"1231",59,"Thailand",1,0,1,2,2020
"1232",63,"Bermuda",1,0,0,1,2020
"1233",63,"Morocco",1,0,0,1,2020
"1234",63,"Puerto Rico",1,0,0,1,2020
"1235",66,"Colombia",0,4,1,5,2020
"1236",67,"Azerbaijan",0,3,4,7,2020
"1237",68,"Dominican Republic",0,3,2,5,2020
"1238",69,"Armenia",0,2,2,4,2020
"1239",70,"Kyrgyzstan",0,2,1,3,2020
"1240",71,"Mongolia",0,1,3,4,2020
"1241",72,"Argentina",0,1,2,3,2020
"1242",72,"San Marino",0,1,2,3,2020
"1243",74,"Jordan",0,1,1,2,2020
"1244",74,"Malaysia",0,1,1,2,2020
"1245",74,"Nigeria",0,1,1,2,2020
"1246",77,"Bahrain",0,1,0,1,2020
"1247",77,"Lithuania",0,1,0,1,2020
"1248",77,"Namibia",0,1,0,1,2020
"1249",77,"North Macedonia",0,1,0,1,2020
"1250",77,"Saudi Arabia",0,1,0,1,2020
"1251",77,"Turkmenistan",0,1,0,1,2020
"1252",83,"Kazakhstan",0,0,8,8,2020
"1253",84,"Mexico",0,0,4,4,2020
"1254",85,"Finland",0,0,2,2,2020
"1255",86,"Botswana",0,0,1,1,2020
"1256",86,"Burkina Faso",0,0,1,1,2020
"1257",86,"Ghana",0,0,1,1,2020
"1258",86,"Grenada",0,0,1,1,2020
"1259",86,"Ivory Coast",0,0,1,1,2020
"1260",86,"Kuwait",0,0,1,1,2020
"1261",86,"Moldova",0,0,1,1,2020
"1262",86,"Syria",0,0,1,1,2020
"1263",1,"United States",40,44,42,126,2024
"1264",2,"China",40,27,24,91,2024
"1265",3,"Japan",20,12,13,45,2024
"1266",4,"Australia",18,19,16,53,2024
"1267",5,"France",16,26,22,64,2024
"1268",6,"Netherlands",15,7,12,34,2024
"1269",7,"Great Britain",14,22,29,65,2024
"1270",8,"South Korea",13,9,10,32,2024
"1271",9,"Italy",12,13,15,40,2024
"1272",10,"Germany",12,13,8,33,2024
"1273",11,"New Zealand",10,7,3,20,2024
"1274",12,"Canada",9,7,11,27,2024
"1275",13,"Uzbekistan",8,2,3,13,2024
"1276",14,"Hungary",6,7,6,19,2024
"1277",15,"Spain",5,4,9,18,2024
"1278",16,"Sweden",4,4,3,11,2024
"1279",17,"Kenya",4,2,5,11,2024
"1280",18,"Norway",4,1,3,8,2024
"1281",19,"Ireland",4,0,3,7,2024
"1282",20,"Brazil",3,7,10,20,2024
"1283",21,"Iran",3,6,3,12,2024
"1284",22,"Ukraine",3,5,4,12,2024
"1285",23,"Romania",3,4,2,9,2024
"1286",24,"Georgia",3,3,1,7,2024
"1287",25,"Belgium",3,1,6,10,2024
"1288",26,"Bulgaria",3,1,3,7,2024
"1289",27,"Serbia",3,1,1,5,2024
"1290",28,"Czech Republic",3,0,2,5,2024
"1291",29,"Denmark",2,2,5,9,2024
"1292",30,"Azerbaijan",2,2,3,7,2024
"1293",30,"Croatia",2,2,3,7,2024
"1294",32,"Cuba",2,1,6,9,2024
"1295",33,"Bahrain",2,1,1,4,2024
"1296",34,"Slovenia",2,1,0,3,2024
"1297",35,"Chinese Taipei",2,0,5,7,2024
"1298",36,"Austria",2,0,3,5,2024
"1299",37,"Hong Kong",2,0,2,4,2024
"1300",37,"Philippines",2,0,2,4,2024
"1301",39,"Algeria",2,0,1,3,2024
"1302",39,"Indonesia",2,0,1,3,2024
"1303",41,"Israel",1,5,1,7,2024
"1304",42,"Poland",1,4,5,10,2024
"1305",43,"Kazakhstan",1,3,3,7,2024
"1306",44,"Jamaica",1,3,2,6,2024
"1307",44,"South Africa",1,3,2,6,2024
"1308",44,"Thailand",1,3,2,6,2024
"1309",47,"Ethiopia",1,3,0,4,2024
"1310",48,"Switzerland",1,2,5,8,2024
"1311",49,"Ecuador",1,2,2,5,2024
"1312",50,"Portugal",1,2,1,4,2024
"1313",51,"Greece",1,1,6,8,2024
"1314",52,"Argentina",1,1,1,3,2024
"1315",52,"Egypt",1,1,1,3,2024
"1316",52,"Tunisia",1,1,1,3,2024
"1317",55,"Botswana",1,1,0,2,2024
"1318",55,"Chile",1,1,0,2,2024
"1319",55,"Saint Lucia",1,1,0,2,2024
"1320",55,"Uganda",1,1,0,2,2024
"1321",59,"Dominican Republic",1,0,2,3,2024
"1322",60,"Guatemala",1,0,1,2,2024
"1323",60,"Morocco",1,0,1,2,2024
"1324",62,"Dominica",1,0,0,1,2024
"1325",62,"Pakistan",1,0,0,1,2024
"1326",64,"Turkey",0,3,5,8,2024
"1327",65,"Mexico",0,3,2,5,2024
"1328",66,"Armenia",0,3,1,4,2024
"1329",66,"Colombia",0,3,1,4,2024
"1330",68,"Kyrgyzstan",0,2,4,6,2024
"1331",68,"North Korea",0,2,4,6,2024
"1332",70,"Lithuania",0,2,2,4,2024
"1333",71,"India",0,1,5,6,2024
"1334",72,"Moldova",0,1,3,4,2024
"1335",73,"Kosovo",0,1,1,2,2024
"1336",74,"Cyprus",0,1,0,1,2024
"1337",74,"Fiji",0,1,0,1,2024
"1338",74,"Jordan",0,1,0,1,2024
"1339",74,"Mongolia",0,1,0,1,2024
"1340",74,"Panama",0,1,0,1,2024
"1341",79,"Tajikistan",0,0,3,3,2024
"1342",80,"Albania",0,0,2,2,2024
"1343",80,"Grenada",0,0,2,2,2024
"1344",80,"Malaysia",0,0,2,2,2024
"1345",80,"Puerto Rico",0,0,2,2,2024
"1346",84,"Cabo Verde",0,0,1,1,2024
"1347",84,"Ivory Coast",0,0,1,1,2024
"1348",84,"Peru",0,0,1,1,2024
"1349",84,"Qatar",0,0,1,1,2024
"1350",84,"Refugee Olympic Team",0,0,1,1,2024
"1351",84,"Singapore",0,0,1,1,2024
"1352",84,"Slovakia",0,0,1,1,2024
"1353",84,"Zambia",0,0,1,1,2024
